border_size=1
usage=map

Gg          , Gg          , Gg          , Gg          , Gg          , Gg          , Gg          , Gg          , Gg          , Gg          , Gg          , Gg          , Gg          , Gg          , Gg          , Gg          , Gg          , Gg          , Mm          , Mm          , Mm          , Mm          , Mm          , Md^Xm       , Mm          , Mm          , Mm          , Md^Xm       , Mm          , Md^Xm       , Mm          , Md^Xm       , Mm          , Gg          , Gg          , Gg          , Gg          , Gg          , Gg          , Gg          , Gg          , Gg          , Gg          , Gg          , Gg          , Gg          
Gg          , Gg          , Gg          , Gg          , Gg          , Gg          , Gg          , Gg          , Gg          , Gg          , Gg          , Gg          , Gg          , Gg          , Mm          , Gg          , Mm          , Mm          , Mm          , Mm          , Mm          , Mm          , Mm          , Mm          , Mm          , Mm          , Mm          , Mm          , Mm          , Mm          , Mm          , Mm          , Mm          , Mm          , Gg          , Gg          , Gg          , Gg          , Gg          , Gg          , Gg          , Gg          , Gg          , Gg          , Gg          , Gg          
Gg          , Gg          , Gg          , Gg          , Gg          , Gg          , Mm          , Gg          , Gg          , Gg          , Mm          , Mm          , Mm          , Mm          , Mm          , Mm          , Mm          , Mm          , Mm          , Mm          , Md^Xm       , Mm          , Mm          , Mm          , Md^Xm       , Mm          , Md^Xm       , Mm          , Mm          , Mm          , Mm          , Mm          , Mm          , Mm          , Mm          , Gg          , Gg          , Gg          , Gg          , Gg          , Gg          , Gg          , Gg          , Gg          , Gg          , Gg          
Gg          , Gg          , Gg          , Gg          , Gg          , Gg          , Gg          , Gg          , Mm          , Mm          , Mm          , Mm          , Mm          , Mm          , Mm          , Mm          , Md^Xm       , Mm          , Md^Xm       , Md^Xm       , Md^Xm       , Md^Xm       , Md^Xm       , Md^Xm       , Md^Xm       , Md^Xm       , Md^Xm       , Md^Xm       , Md^Xm       , Md^Xm       , Md^Xm       , Mm          , Mm          , Mm          , Mm          , Mm          , Gg          , Gg          , Gg          , Gg          , Gg          , Gg          , Gg          , Gg          , Gg          , Gg          
Gg          , Gg          , Gg          , Gg          , Gg          , Gg          , Gg          , Gg          , Mm          , Mm          , Mm          , Mm          , Md^Xm       , Md^Xm       , Md^Xm       , Md^Xm       , Md^Xm       , Md^Xm       , Md^Xm       , Md^Xm       , Md^Xm       , Md^Xm       , Md          , Md^Xm       , Md^Xm       , Md^Xm       , Md^Xm       , Md^Xm       , Md^Xm       , Md^Xm       , Md^Xm       , Md^Xm       , Md^Xm       , Mm          , Mm          , Mm          , Mm          , Gg          , Gg          , Gg          , Gg          , Gg          , Gg          , Gg          , Gg          , Gg          
Gg          , Gg          , Gg          , Gg          , Gg          , Gg          , Mm          , Mm          , Mm          , Mm          , Md^Xm       , Md^Xm       , Md^Xm       , Md^Xm       , Md^Xm       , Md^Xm       , Md^Xm       , Md^Xm       , Md          , Md          , Md          , Md          , Md          , Md          , Md          , Md^Xm       , Md^Xm       , Md^Xm       , Md^Xm       , Md^Xm       , Md^Xm       , Md^Xm       , Md^Xm       , Md^Xm       , Md^Xm       , Mm          , Mm          , Mm          , Gg          , Gg          , Gg          , Gg          , Gg          , Gg          , Gg          , Gg          
Gg          , Gg          , Gg          , Gg          , Gg          , Gg          , Mm          , Mm          , Mm          , Md^Xm       , Md^Xm       , Md^Xm       , Md^Xm       , Md^Xm       , Md^Xm       , Md^Xm       , Md          , Md          , Md          , Md          , Md          , Md          , 1 Md        , Md          , Md          , Md          , Md          , Md^Xm       , Md^Xm       , Md^Xm       , Md^Xm       , Md^Xm       , Md^Xm       , Md^Xm       , Md^Xm       , Mm          , Mm          , Mm          , Mm          , Gg          , Gg          , Gg          , Gg          , Gg          , Gg          , Gg          
Gg          , Gg          , Gg          , Gg          , Mm          , Mm          , Mm          , Mm          , Md^Xm       , Md^Xm       , Md^Xm       , Md^Xm       , Md^Xm       , Md^Xm       , Md          , Md          , Md          , Md          , Md          , Md          , Md          , Md          , Uh          , Md          , Md          , Md          , Md          , Md          , Md          , Md          , Md          , Md^Xm       , Md^Xm       , Md^Xm       , Md^Xm       , Md^Xm       , Mm          , Mm          , Mm          , Gg          , Gg          , Gg          , Gg          , Gg          , Gg          , Gg          
Gg          , Gg          , Gg          , Gg          , Mm          , Mm          , Mm          , Md^Xm       , Md^Xm       , Md^Xm       , Md^Xm       , Md^Xm       , Md          , Md          , Md          , Md          , Md          , Md          , Uh          , Uh          , Uh          , Uh          , Uh          , Uh          , Uh          , Md          , Md          , Md          , Md          , Md          , Md          , Md          , 4 Md        , Md^Xm       , Md^Xm       , Md^Xm       , Md^Xm       , Mm          , Mm          , Mm          , Gg          , Gg          , Gg          , Gg          , Gg          , Gg          
Mm          , Gg          , Gg          , Gg          , Mm          , Mm          , Md^Xm       , Md^Xm       , Md^Xm       , Md^Xm       , Md^Xm       , Md^Xm       , Md          , Md          , Md          , Md          , Uh          , Uh          , Uh          , Uh          , Uh          , Uh          , Uh          , Uh          , Uh          , Uh          , Uh          , Uh          , Uh          , Md          , Md          , Md          , Md          , Md^Xm       , Md^Xm       , Md^Xm       , Md^Xm       , Mm          , Mm          , Mm          , Mm          , Gg          , Gg          , Gg          , Gg          , Gg          
Mm          , Mm          , Mm          , Mm          , Mm          , Mm          , Md^Xm       , Md^Xm       , Md^Xm       , Md^Xm       , Md          , Md          , Md          , Md          , Uh          , Uh          , Uh          , Uh          , Uh          , Uu          , Uh          , Uh          , Uu          , Uh          , Uh          , Uh          , Uh          , Uh          , Uh          , Uh          , Uh          , Md          , Md          , Md          , Md          , Md^Xm       , Md^Xm       , Md^Xm       , Mm          , Mm          , Mm          , Gg          , Mm          , Mm          , Mm          , Gg          
Mm          , Mm          , Mm          , Mm          , Mm          , Mm          , Md^Xm       , Md^Xm       , Md^Xm       , Md^Xm       , Md          , Md          , Md          , Qxu         , Uh          , Qxu         , Qxu         , Uh          , Uh          , Uh          , Uu          , Uh          , Uh          , Uh          , Uh          , Uu          , Uh          , Uh          , Uh          , Uu          , Uh          , Uh          , Md          , Md          , Md          , Md^Xm       , Md^Xm       , Md^Xm       , Md^Xm       , Mm          , Mm          , Mm          , Mm          , Mm          , Mm          , Mm          
Mm          , Mm          , Mm          , Mm          , Mm          , Md^Xm       , Md^Xm       , Md^Xm       , Md^Xm       , Md^Xm       , Md          , Md          , Md          , Uh          , Uh          , Uh          , Uh          , Uh          , Uh          , Uh          , Uh          , Uh          , Uu          , Uh          , Uh          , Uh          , Uh          , Uu          , Uh          , Uh          , Uh          , Uh          , Md          , Md          , Md          , Md          , Md          , Md^Xm       , Md^Xm       , Mm          , Mm          , Mm          , Mm          , Mm          , Mm          , Mm          
Mm          , Mm          , Mm          , Mm          , Mm          , Md^Xm       , Md^Xm       , Md^Xm       , Md^Xm       , Md          , Md          , Md          , Uh          , Uh          , Uh          , Uh          , Uh          , Qxu         , Uh          , Uh          , Uu          , Uu          , Ql          , Uu          , Uu          , Uh          , Uh          , Uh          , Uh          , Uh          , Uh          , Uh          , Uh          , Md          , Md          , Md          , Md          , Md^Xm       , Md^Xm       , Md^Xm       , Mm          , Mm          , Mm          , Mm          , Mm          , Gg          
Mm          , Mm          , Mm          , Mm          , Mm          , Md^Xm       , Md^Xm       , Md^Xm       , Md^Xm       , Md          , Md          , Md          , Uh          , Uh          , Uh          , Uh          , Uh          , Uh          , Qxu         , Uu          , Ql          , Ql          , Ql          , Ql          , Ql          , Uu          , Uh          , Uh          , Qxu         , Uh          , Qxu         , Uh          , Qxu         , Uh          , Md          , Md          , Md          , Md^Xm       , Md^Xm       , Md^Xm       , Mm          , Mm          , Mm          , Mm          , Mm          , Gg          
Mm          , Mm          , Mm          , Mm          , Mm          , Md^Xm       , Md^Xm       , Md^Xm       , Md          , Md          , Md          , Uh          , Uh          , Uh          , Uh          , Qxu         , Uh          , Uh          , Uh          , Uu          , Ql          , Ql          , Ql          , Ql          , Ql          , Uu          , Uh          , Qxu         , Uh          , Uh          , Uh          , Uh          , Uh          , Uh          , Md          , Md          , Md          , Md^Xm       , Md^Xm       , Md^Xm       , Mm          , Mm          , Mm          , Mm          , Mm          , Gg          
Mm          , Mm          , Mm          , Mm          , Mm          , Md^Xm       , Md^Xm       , Md^Xm       , Md          , Md          , Md          , Uh          , Uu          , Uh          , Uh          , Uh          , Uh          , Uh          , Uh          , Uu          , Ql          , Ql          , Ql          , Ql          , Ql          , Uu          , Uh          , Uh          , Uu          , Uh          , Uh          , Uh          , Uh          , Uh          , Md          , Md          , Md^Xm       , Md^Xm       , Md^Xm       , Mm          , Mm          , Mm          , Mm          , Mm          , Mm          , Gg          
Mm          , Mm          , Mm          , Mm          , Mm          , Mm          , Md^Xm       , Md^Xm       , Md^Xm       , Md          , Md          , Uh          , Uh          , Uh          , Uh          , Uh          , Uh          , Uu          , Uh          , Uu          , Uu          , Ql          , Ql          , Ql          , Uu          , Uu          , Uh          , Uh          , Uh          , Uh          , Uh          , Uh          , 3 Md        , Md          , Md          , Md          , Md^Xm       , Md^Xm       , Md^Xm       , Mm          , Mm          , Mm          , Mm          , Mm          , Mm          , Gg          
Mm          , Mm          , Mm          , Mm          , Mm          , Mm          , Md^Xm       , Md^Xm       , Md^Xm       , Md          , Md          , Md          , Uh          , Uh          , Uh          , Uu          , Uh          , Uh          , Uh          , Uu          , Uh          , Uu          , Uu          , Uu          , Uh          , Uh          , Uh          , Uh          , Uh          , Uu          , Uh          , Uh          , Md          , Md          , Md          , Md          , Md^Xm       , Md^Xm       , Mm          , Mm          , Mm          , Mm          , Mm          , Mm          , Gg          , Gg          
Mm          , Mm          , Mm          , Mm          , Mm          , Mm          , Md^Xm       , Md^Xm       , Md^Xm       , Md          , Md          , Md          , Uh          , Uh          , Uh          , Uh          , Uu          , Uh          , Uh          , Uh          , Qxu         , Uh          , Uh          , Uh          , Uh          , Uh          , Uu          , Uu          , Uh          , Uh          , Uh          , Uh          , Md          , Md          , Md^Xm       , Md^Xm       , Md^Xm       , Md^Xm       , Mm          , Mm          , Mm          , Gg          , Gg          , Gg          , Gg          , Gg          
Mm          , Mm          , Mm          , Mm          , Mm          , Mm          , Md^Xm       , Md^Xm       , Md^Xm       , Md          , Md          , Md          , Md          , Uh          , Uh          , Uh          , Uh          , Uh          , Uh          , Uh          , Qxu         , Uh          , Uh          , Uh          , Uh          , Uh          , Uh          , Uh          , Uh          , Uh          , Uh          , Md          , Md          , Md          , Md^Xm       , Md^Xm       , Md^Xm       , Md^Xm       , Mm          , Mm          , Mm          , Gg          , Gg          , Gg          , Gg          , Gg          
Mm          , Mm          , Mm          , Mm          , Mm          , Mm          , Mm          , Md^Xm       , Md^Xm       , Md^Xm       , Md^Xm       , Md          , Md          , 2 Md        , Uh          , Uh          , Uh          , Uu          , Uh          , Uh          , Uh          , Uh          , Uh          , Uh          , Uu          , Uh          , Uh          , Uh          , Uh          , Uh          , Md          , Md          , Md          , Md          , Md^Xm       , Md^Xm       , Mm          , Mm          , Mm          , Mm          , Gg          , Gg          , Gg          , Gg          , Gg          , Gg          
Mm          , Mm          , Mm          , Mm          , Mm          , Mm          , Mm          , Md^Xm       , Md^Xm       , Md^Xm       , Md^Xm       , Md          , Md          , Md          , Md          , Uh          , Uh          , Uh          , Uh          , Uh          , Uh          , Uh          , Uu          , Uh          , Uh          , Uu          , Uh          , Uh          , Uh          , Uh          , Md          , Md          , Md          , Md^Xm       , Md^Xm       , Md^Xm       , Mm          , Mm          , Mm          , Gg          , Gg          , Gg          , Gg          , Gg          , Gg          , Gg          
Mm          , Mm          , Mm          , Mm          , Mm          , Mm          , Mm          , Mm          , Md^Xm       , Md^Xm       , Md^Xm       , Md^Xm       , Md          , Md          , Md          , Md          , Md          , Uh          , Md          , Uh          , Uh          , Uh          , Uh          , Uh          , Uh          , Uh          , Uh          , Uh          , Md          , Md          , Md          , Md          , Md^Xm       , Md^Xm       , Md^Xm       , Md^Xm       , Mm          , Mm          , Gg          , Gg          , Gg          , Gg          , Gg          , Gg          , Gg          , Gg          
Gg          , Gg          , Gg          , Gg          , Gg          , Mm          , Mm          , Mm          , Mm          , Md^Xm       , Md^Xm       , Md^Xm       , Md^Xm       , Md          , Md          , Md          , Md          , Md          , Md          , Md          , Md          , Uh          , Md          , Uh          , Uh          , Uh          , Md          , Md          , Md          , Md          , Md          , Md^Xm       , Md^Xm       , Md^Xm       , Md^Xm       , Mm          , Mm          , Mm          , Gg          , Gg          , Gg          , Gg          , Gg          , Gg          , Gg          , Gg          
Gg          , Gg          , Gg          , Gg          , Gg          , Gg          , Mm          , Mm          , Mm          , Md^Xm       , Md^Xm       , Md^Xm       , Md^Xm       , Md^Xm       , Md^Xm       , Md          , Md^Xm       , Md          , Md          , Md          , Md          , Md          , Md          , Md          , Md          , Md          , Md          , Md          , Md          , Md          , Md^Xm       , Md^Xm       , Md^Xm       , Md^Xm       , Mm          , Mm          , Mm          , Mm          , Gg          , Gg          , Gg          , Gg          , Gg          , Gg          , Gg          , Gg          
Gg          , Gg          , Gg          , Gg          , Gg          , Gg          , Gg          , Mm          , Mm          , Mm          , Mm          , Md^Xm       , Mm          , Md^Xm       , Md^Xm       , Md^Xm       , Md^Xm       , Md^Xm       , Md^Xm       , Md          , Md^Xm       , Md          , Md          , Md          , Md          , Md          , Md          , Md          , Md^Xm       , Md^Xm       , Md^Xm       , Md^Xm       , Mm          , Mm          , Mm          , Mm          , Gg          , Gg          , Gg          , Gg          , Gg          , Gg          , Gg          , Gg          , Gg          , Gg          
Gg          , Gg          , Gg          , Gg          , Gg          , Gg          , Gg          , Mm          , Mm          , Mm          , Mm          , Mm          , Mm          , Mm          , Mm          , Mm          , Mm          , Md^Xm       , Md^Xm       , Md^Xm       , Md^Xm       , Md^Xm       , Md^Xm       , Md^Xm       , Md^Xm       , Md          , Md^Xm       , Md^Xm       , Md^Xm       , Md^Xm       , Md^Xm       , Mm          , Mm          , Mm          , Mm          , Mm          , Gg          , Gg          , Gg          , Gg          , Gg          , Gg          , Gg          , Gg          , Gg          , Gg          
Gg          , Gg          , Gg          , Gg          , Gg          , Gg          , Gg          , Gg          , Gg          , Mm          , Mm          , Mm          , Mm          , Mm          , Mm          , Mm          , Mm          , Md^Xm       , Mm          , Md^Xm       , Mm          , Md^Xm       , Md^Xm       , Md^Xm       , Md^Xm       , Md^Xm       , Md^Xm       , Md^Xm       , Mm          , Mm          , Mm          , Mm          , Mm          , Mm          , Gg          , Gg          , Gg          , Gg          , Gg          , Gg          , Gg          , Gg          , Gg          , Gg          , Gg          , Gg          
Gg          , Gg          , Gg          , Gg          , Gg          , Gg          , Gg          , Gg          , Gg          , Gg          , Gg          , Gg          , Gg          , Gg          , Gg          , Mm          , Gg          , Mm          , Mm          , Mm          , Mm          , Mm          , Mm          , Mm          , Mm          , Mm          , Mm          , Mm          , Mm          , Mm          , Mm          , Gg          , Gg          , Gg          , Gg          , Gg          , Gg          , Gg          , Gg          , Gg          , Gg          , Gg          , Gg          , Gg          , Gg          , Gg          
Gg          , Gg          , Gg          , Gg          , Gg          , Gg          , Gg          , Gg          , Gg          , Gg          , Gg          , Gg          , Gg          , Gg          , Gg          , Gg          , Gg          , Mm          , Mm          , Mm          , Mm          , Mm          , Mm          , Mm          , Mm          , Mm          , Mm          , Mm          , Mm          , Mm          , Gg          , Gg          , Gg          , Gg          , Gg          , Gg          , Gg          , Gg          , Gg          , Gg          , Gg          , Gg          , Gg          , Gg          , Gg          , Gg          
Gg          , Gg          , Gg          , Gg          , Gg          , Gg          , Gg          , Gg          , Gg          , Gg          , Gg          , Gg          , Gg          , Gg          , Gg          , Gg          , Gg          , Gg          , Gg          , Gg          , Gg          , Gg          , Gg          , Mm          , Gg          , Mm          , Gg          , Gg          , Gg          , Gg          , Gg          , Gg          , Gg          , Gg          , Gg          , Gg          , Gg          , Gg          , Gg          , Gg          , Gg          , Gg          , Gg          , Gg          , Gg          , Gg          
Gg          , Gg          , Gg          , Gg          , Gg          , Gg          , Gg          , Gg          , Gg          , Gg          , Gg          , Gg          , Gg          , Gg          , Gg          , Gg          , Gg          , Gg          , Gg          , Gg          , Gg          , Gg          , Gg          , Gg          , Gg          , Gg          , Gg          , Gg          , Gg          , Gg          , Gg          , Gg          , Gg          , Gg          , Gg          , Gg          , Gg          , Gg          , Gg          , Gg          , Gg          , Gg          , Gg          , Gg          , Gg          , Gg          
Gg          , Gg          , Gg          , Gg          , Gg          , Gg          , Gg          , Gg          , Gg          , Gg          , Gg          , Gg          , Gg          , Gg          , Gg          , Gg          , Gg          , Gg          , Gg          , Gg          , Gg          , Gg          , Gg          , Gg          , Gg          , Gg          , Gg          , Gg          , Gg          , Gg          , Gg          , Gg          , Gg          , Gg          , Gg          , Gg          , Gg          , Gg          , Gg          , Gg          , Gg          , Gg          , Gg          , Gg          , Gg          , Gg          
Gg          , Gg          , Gg          , Gg          , Gg          , Gg          , Gg          , Gg          , Gg          , Gg          , Gg          , Gg          , Gg          , Gg          , Gg          , Gg          , Gg          , Gg          , Gg          , Gg          , Gg          , Gg          , Gg          , Gg          , Gg          , Gg          , Gg          , Gg          , Gg          , Gg          , Gg          , Gg          , Gg          , Gg          , Gg          , Gg          , Gg          , Gg          , Gg          , Gg          , Gg          , Gg          , Gg          , Gg          , Gg          , Gg          
