Wot, Wot, Wot, Wot, Wot, Wot, Wot, Wot, Wot, Wot, Wot, Wot, Wot, Wot, Wot, Wot, Wot, Wot, Wot, Wwt, Wot, Wot, Wot, Wot, Wot, Wot, Wot, Wot, Wwt, Wwt, Wwt, Wwt, Wwt, Wwt, Wwt, Wwt, Wwt, Wwt, Wwt, Wwt, Wwt, Wwt, Wwt, Wwt, Wwt, Wwt, Wwt, Wwt, Wwt, Wwt, Wwt, Wwt, Wwt, Wwt, Wwt, Wwt, Wwt, Wwt, Wwt, Wwt, Wwt, Wwt, Wwt, Wwt, Wwt, Wwt, Wwt, Wwt, Wwt, Wwt, Wot, Wot, Wot, Wot, Wot, Wot, Wot, Wot, Wot, Wot, Wot, Wot
Wot, Wot, Wot, Wot, Wot, Wot, Wot, Wot, Wot, Wot, Wot, Wot, Wot, Wot, Wot, Wot, Wot, Wot, Wot, Wot, Wot, Wot, Wwt, Wot, Wwt, Wot, Wwt, Wwt, Wwt, Wwt, Wwt, Wwt, Wwt, Wwt, Wwt, Wwt, Wwt, Wwt, Wwt, Wwt, Wwt, Wwt, Wwt, Wwt, Ww, Wwt, Wwt, Wwt, Wwt, Wwt, Wwt, Wwt, Wwt, Wwt, Wwt, Wwt, Wwt, Wwt, Wwt, Wwt, Wwt, Wwt, Wwrt, Wwt, Wwt, Wwt, Wwt, Wwt, Wwt, Wwt, Wwt, Wot, Wot, Wot, Wot, Wot, Wot, Wot, Wot, Wot, Wot, Wot
Wot, Wot, Wot, Wot, Wot, Wot, Wot, Wot, Wot, Wot, Wot, Wot, Wot, Wot, Wot, Wot, Wot, Wot, Wot, Wot, Wwt, Wwt, Wwt, Wwt, Wwt, Wwt, Wwt, Wwt, Wwt, Wwt, Wwt, Wwt, Wwt, Wwt, Ww, Wwt, Wwt, Ww, Ww, Ww, Ww, Wwt, Wwt, Wwt, Ww, Ww, Wwt, Wwt, Wwt, Wwt, Wwt, Wwt, Wwt, Wwt, Wwt, Wwt, Wwt, Wwt, Wwt, Wwt, Wwt, Wwrt, Mm, Wwt, Wwt, Wwt, Mm, Wwt, Wwt, Wwt, Wwt, Wwt, Wot, Wot, Wot, Wot, Wot, Wot, Wot, Wot, Wot, Wot
Wot, Wot, Wot, Wot, Wot, Wot, Wot, Wot, Wot, Wot, Wot, Wot, Wot, Wot, Wot, Wot, Wot, Wot, Wwt, Wwt, Wwt, Wwt, Wwt, Wwt, Ww, Wwt, Ww, Wwt, Wwt, Wwt, Wwt, Wwt, Wwt, Wwt, Wwt, Ww, Wwt, Wwt, Wwt, Ww, Ww, Wwt, Wwt, Wwt, Wwt, Wwt, Wwt, Wwt, Mm, Wwt, Mm, Wwt, Mm, Wwt, Mm, Wwrt, Mm, Wwt, Wwrt, Wwrt, Wwr, Mm, Mm, Mm, Mm, Mm, Mm, Wwt, Wwt, Wwt, Wwt, Wwt, Wot, Wot, Wot, Wot, Wot, Wot, Wot, Wot, Wot, Wot
Wot, Wot, Wot, Wot, Wot, Wot, Wot, Wot, Wot, Wot, Wot, Wot, Wot, Wot, Wwt, Wwt, Wwt, Wwt, Wwt, Wwt, Mm, Mm, Mm, Wwt, Wwt, Ww, Ww, Ww, Ww, Wwt, Wwt, Wwt, Mm, Wwt, Mm, Wwt, Wwt, Wwt, Wwt, Wwt, Ww, Wwt, Wwt, Wwt, Wwt, Wwt, Mm, Mm, Mm, Mm, Gll^Ftr, Mm, Mm, Mm, Mm, Mm, Mm, Mm, Mm, Wwr, Wwrt, Mm, Mm, Mm, Mm, Mm, Wwt, Wwt, Wwt, Wwt, Wwt, Wwt, Wot, Wot, Wot, Wot, Wot, Wot, Wot, Wot, Wot, Wot
Wot, Wot, Wot, Wot, Wot, Wot, Wot, Wot, Wot, Wot, Wot, Wot, Wot, Wot, Wwt, Wwt, Wwt, Wwt, Mm, Mm, Mm, Mm, Mm, Wwr, Wwr, Wwt, Wwt, Ww, Ww, Wwt, Wwt, Mm, Mm, Mm, Mm, Mm, Mm, Mm, Mm, Wwt, Wwt, Wwt, Mm, Mm, Mm, Mm, Mm, Mm, Mm, Mm, Gll^Ftr, Gll^Ftr, Mm, Mm, Mm, Mm, Mm, Mm, Mm, Wwr, Wwt, Wwrt, Wwt, Wwt, Wwt, Wwt, Wwt, Wwt, Wwt, Wwt, Wwt, Wot, Wot, Wot, Wot, Wot, Wot, Wot, Wot, Wot, Wot, Wot
Wot, Wot, Wot, Wot, Wot, Wot, Wot, Wot, Wot, Wot, Wot, Wot, Wot, Wwt, Ww, Wwt, Wwt, Wwt, Wwt, Mm, Wwt, Wwt, Mm, Mm, Mm, Wwt, Wwt, Ww, Wwt, Wwt, Wwt, Mm, Mm, Mm, Mm, Mm, Mm, Mm, Mm, Wwt, Mm, Mm, Mm, Mm, Mm, Mm, Mm, Mm, Mm, Mm, Gll^Ftr, Mm, Gs^Ft, Mm, Gs^Ft, Gs^Ft, Dd^Ftd, Mm, Wwrt, Wwrt, Wwt, Wwt, Wwt, Wwt, Wwt, Wwt, Wwt, Wwt, Wwt, Wwt, Wot, Wot, Wot, Wot, Wot, Wot, Wot, Wot, Wot, Wot, Wot, Wot
Wot, Wot, Wot, Wot, Wot, Wot, Wot, Wot, Wot, Wot, Wot, Wot, Wot, Ww, Wwt, Wwt, Wwt, Wwt, Wwt, Wwt, Wwt, Mm, Wwr, Mm, Mm, Mm, Mm, Wwt, Wwt, Wwt, Wwr, Wwr, Mm, Mm, Uh, Mm, Mm, Mm, Mm, Mm, Mm, Mm, Mm, Mm, Gll^Ftr, Mm, Gll^Ftr, Mm, Gll^Ftr, Gll^Ftr, Gs, Gs^Ft, Gs^Ft, Gs^Ft, Gs, Gs, Ds, Dd^Ftd, Wwrt, Wwt, Wwt, Wwt, Wwt, Wwt, Wwt, Wwt, Wwt, Wwt, Wwt, Wot, Wot, Wot, Wot, Wot, Wot, Wot, Wot, Wot, Wot, Wot, Wot, Wot
Wot, Wot, Wot, Wot, Wot, Wot, Wot, Wot, Wot, Wot, Wot, Wot, Wot, Wwt, Wwt, Wwt, Ww, Wwt, Wwt, Wwt, Wwt, Wwt, Wwr, Wwt, Wwt, Mm, Mm, Mm, Wwr, Wwr, Mm, Mm, Uh, Ur, Ql, Uh, Ur, Mm, Mm, Mm, Mm, Mm, Gll^Ftr, Gll^Ftr, Gll^Ftr, Gll^Ftr, Gs^Ft, Gll^Ftr, Gs^Ft, Gs, Gs, Gs, Gs^Ft, Gs^Ft, Ds, Ds, Ds, Ds, Wwt, Wwt, Wwt, Wwt, Wwt, Wwt, Wwt, Wwt, Wwt, Wwt, Wot, Wot, Wot, Wot, Wot, Wot, Wot, Wot, Wot, Wot, Wot, Wot, Wot, Wot
Wot, Wot, Wot, Wot, Wot, Wot, Wot, Wot, Wot, Wot, Wot, Wot, Wwt, Wwt, Wwt, Wwt, Ww, Wwt, Wwt, Wwt, Wwt, Wwt, Mm, Mm, Mm, Wwt, Wwt, Mm, Wwr, Mm, Mm, Mm, Uh, Ql, Ql, Ql, Uh, Mm, Mm, Mm, Gll^Ftr, Gll^Ftr, Gll^Ftr, Gll^Ftr, Gs^Ft, Gs^Ft, Gs^Ft, Gs^Ft, Gs, Gs, Gs, Gs, Gs^Ft, Dd^Ftd, Ds, Ds, Wwt, Wwt, Wwt, Wwt, Wwt, Wwt, Wwt, Wwt, Wwt, Wwt, Wwt, Wot, Wot, Wot, Wot, Wot, Wot, Wot, Wot, Wot, Wot, Wot, Wot, Wot, Wot, Wot
Wot, Wot, Wot, Wot, Wot, Wot, Wot, Wot, Wot, Wot, Wwt, Wwt, Wwt, Wwt, Wwt, Wwr, Ww, Ww, Ww, Wwt, Wwt, Mm, Mm, Wwt, Wwt, Mm, Wwr, Wwr, Mm, Mm, Mm, Mm, Ur, Uh, Ur, Uh, Mm, Mm, Mm, Mm, Gll^Ftr, Gll^Ftr, Gll^Ftr, Gs^Ft, Gs^Ft, Gs^Ft, Gs, Gs, Gs, Gs^Ft, Gs^Ft, Gs^Ft, Dd^Ftd, Ds, Ds, Ds, Ds, Wwt, Wwt, Wwt, Wwt, Wwt, Wwt, Wwt, Wwt, Wwt, Wwt, Wot, Wot, Wot, Wot, Wot, Wot, Wot, Wot, Wot, Wot, Wot, Wot, Wot, Wot, Wot
Wot, Wot, Wot, Wot, Wot, Wot, Wot, Wot, Wwt, Wwt, Wwt, Wwt, Wwt, Wwt, Wwt, Wwr, Ww, Ww, Wwt, Wwt, Wwt, Mm, Mm, Mm, Mm, Wwr, Mm, Mm, Mm, Mm, Mm, Gll^Ftr, Mm, Ur, Mm, Mm, Mm, Mm, Gll^Ftr, Gll^Ftr, Gll^Ftr, Gll^Ftr, Gs^Ft, Gs^Ft, Gs, Gs^Ft, Gs^Ft, Gs, Gs, Gs, Gs^Ft, Dd^Ftd, Gs^Ft, Gs, Ds, Ds, Ds, Wwt, Wwt, Wwt, Wwt, Wwt, Wwt, Wwt, Wwt, Wwt, Wwt, Wot, Wot, Wot, Wot, Wot, Wot, Wot, Wot, Wot, Wot, Wot, Wot, Wot, Wot, Wot
Wot, Wot, Wot, Wot, Wot, Wot, Wwt, Wwt, Wwt, Wwt, Wwt, Wwt, Wwr, Wwt, Wwt, Ww, Ww, Ww, Ww, Ww, Wwt, Mm, Mm, Mm, Mm, Mm, Mm, Mm, Mm, Mm, Gll^Ftr, Gll^Ftr, Mm, Mm, Mm, Mm, Mm, Mm, Gll^Ftr, Gll^Ftr, Gs^Ft, Gs^Ft, Gs^Ft, Gs, Gs^Ft, Gs^Ft, Gs^Ft, Gs^Ft, Gs^Ft, Gs^Ft, Gs^Ft, Gs^Ft, Gs^Ft, Gs^Ft, Ds, Ds, Ds, Wwt, Wwt, Wwt, Wwt, Wwt, Wwt, Wwt, Wwt, Wwt, Wot, Wot, Wot, Wot, Wot, Wot, Wot, Wot, Wot, Wot, Wot, Wot, Wot, Wot, Wot, Wot
Wot, Wot, Wot, Wot, Wot, Wwt, Wwt, Wwt, Wwt, Wwt, Wwt, Wwr, Ww, Ww, Ww, Ww, Ww, Ww, Wwt, Wwt, Wwt, Mm, Mm, Mm, Mm, Mm, Mm, Mm, Gll^Ftr, Gll^Ftr, Mm, Mm, Mm, Mm, Mm, Mm, Mm, Mm, Gll^Ftr, Gll^Ftr, Gs^Ft, Gs^Ft, Gs, Gs^Ft, Gs^Ft, Gs^Ft, Gs^Ft, Gs^Ft, Dd^Ftd, Dd^Ftd, Dd^Ftd, Gs^Ft, Gs, Ds, Ds, Ds, Ds, Wwt, Wwt, Wwt, Wwt, Wwt, Wwt, Wwt, Wwt, Wwt, Wot, Wot, Wot, Wot, Wot, Wot, Wot, Wot, Wot, Wot, Wot, Wot, Wot, Wot, Wot, Wot
Wot, Wot, Wot, Wot, Wwt, Wwt, Wwt, Wwt, Wwt, Wwt, Wwt, Wwr, Ww, Ww, Ww, Ww, Ww, Ww, Wwt, Wwt, Wwt, Wwt, Mm, Mm, Mm, Mm, Mm, Gll^Ftr, Gll^Ftr, Gs^Ftp, Mm, Mm, Mm, Mm, Mm, Wwrt, Gll^Ftr, Gll^Ftr, Gll^Ftr, Gs^Ft, Gs^Ft, Rr^Vd, Gs^Ft, Gs^Ft, Gs^Ft, Gs^Ft, Dd^Ftd, Gs^Ft, Dd^Ftd, Dd^Ftd, Ds, Ds, Ds, Ds, Ds, Ds, Wwt, Wwt, Wwt, Wwt, Wwt, Wwt, Wwt, Wwt, Wwt, Wwt, Wot, Wot, Wot, Wot, Wot, Wot, Wot, Wot, Wot, Wot, Wot, Wot, Wot, Wot, Wot, Wot
Wot, Wot, Wot, Wot, Wwt, Wwt, Wwt, Wwt, Wwt, Wwt, Wwt, Ww, Ww, Ww, Wwt, Ww, Wwt, Wwt, Wwt, Wwt, Mm, Mm, Mm, Mm, Mm, Mm, Gll^Ftr, Gll^Ftr, Ww^Ewf, Gll^Ftr, Gll^Ftr, Mm, Mm, Mm, Mm, Wwrt, Wwt, Gll^Ftr, Gs^Ft, Gs^Ft, Gs^Ft, Gs^Ft, Gs^Ft, Gs^Ft, Gs^Ft, Dd^Ftd, Gs^Ft, Dd^Ftd, Dd^Ftd, Gs^Ftp, Ds, Ds, Ds, Ds, Wwt, Wwt, Wwt, Wwt, Wwt, Wwt, Wwt, Wwt, Wwt, Wwt, Wwt, Wwt, Wot, Wot, Wot, Wot, Wot, Wot, Wot, Wot, Wot, Wot, Wot, Wot, Wot, Wot, Wot, Wot
Wot, Wot, Wot, Wwt, Wwt, Wwt, Wwt, Wwt, Wwt, Wwt, Wwt, Wwr, Ww, Ww, Wwt, Wwt, Wwt, Wwt, Mm, Mm, Mm, Mm, Gll^Ftr, Mm, Gll^Ftr, Gll^Ftr, Gll^Ftr, Ww^Ewl, Rr^Vd, Ww^Ewl, Gll^Ftr, Gll^Ftr, Mm, Mm, Mm, Gll^Ftr, Gll^Ftr, Wwt, Wwt, Gs^Ft, Gs^Ft, Gs, Gs, Gs^Ft, Gs^Ft, Gs^Ft, Gs^Ft, Gs^Ft, Ds, Ds, Ds, Ds, Wwt, Wwt, Wwt, Wwt, Wwt, Wwt, Wwt, Wwt, Wwt, Wwt, Wwt, Wwt, Wwt, Wwt, Wot, Wot, Wot, Wot, Wot, Wot, Wot, Wot, Wot, Wot, Wot, Wot, Wot, Wot, Wot, Wot
Wot, Wot, Wot, Wwt, Wwt, Wwt, Wwt, Wwt, Wwt, Wwt, Wwr, Ww, Ww, Ww, Wwt, Wwt, Wwt, Mm, Mm, Mm, Mm, Gll^Ftr, Ww^Ewf, Ww^Ewf, Mm, Gll^Ftr, Gll^Ftr, Ww^Ewf, Ww^Ewl, Gll^Ftr, Gll^Ftr, Gll^Ftr, Mm, Mm, Mm, Gll^Ftr, Gll^Ftr, Gll^Ftr, Gll^Ftr, Wwt^Bp/, Gs^Ft, Gs^Ft, Gs^Ft, Gs^Ft, Gs, Gs^Ft, Gs^Ft, Gs^Ft, Ds, Ds, Ds, Wwt, Wwt, Wwt, Wwt, Wwt, Wwt, Wwt, Wwt, Wwt, Wwt, Wwt, Wwt, Wwt, Wwt, Wwt, Wot, Wot, Wot, Wot, Wot, Wot, Wot, Wot, Wot, Wot, Wot, Wot, Wot, Wot, Wot, Wot
Wot, Wot, Wot, Wwt, Wwt, Wwt, Wwt, Wwt, Wwt, Wwr, Ww, Ww, Ww, Wwt, Wwt, Wwt, Wwt, Mm, Mm, Mm, Mm, Mm, Mm, Mm, Mm, Mm, Mm, Gll^Ftr, Gll^Ftr, Wwt, Wwt, Gll^Ftr, Mm, Mm, Mm, Gll^Ftr, Gg^Emf, Gll^Ftr, Gs^Ftp, Wwt, Gs^Ft, Gs^Ft, Gs^Ft, Gs^Ft, Gs^Ft, Gs, Rr^Vd, Gs^Ft, Dd^Ftd, Ds, Ds, Wwt, Wwt, Wwt, Wwt, Wwt, Wwt, Wwt, Wwt, Wwt, Wwt, Wwt, Wwt, Wwt, Wwt, Wwt, Wot, Wot, Wot, Wot, Wot, Wot, Wot, Wot, Wot, Wot, Wot, Wot, Wot, Wot, Wot, Wot
Wot, Wot, Wwt, Wwt, Wwt, Wwt, Wwt, Wwt, Wwt, Wwr, Ww, Ww, Wwt, Wwt, Wwt, Wwt, Wwt, Mm, Mm, Mm, Mm, Mm, Mm, Mm, Mm, Mm, Mm, Gll^Ftr, Gll^Ftr, Gll^Ftr, Wwt, Gll^Ftr, Gll^Ftr, Mm, Gll^Ftr, Gll^Ftr, Gll^Ftr, Gll^Ftr, Gll^Ftr, Wwt, Wwt, Gs^Ft, Gs^Ft, Gs^Ft, Gs^Ft, Gs^Ft, Gs^Ft, Gs^Ft, Gs, Ds, Ds, Ds, Wwt, Wwt, Wwt, Wwt, Wwt, Wwt, Wwt, Wwt, Wwt, Wwt, Wwt, Wwt, Wwt, Wwt, Wwt, Wot, Wot, Wot, Wot, Wot, Wot, Wot, Wot, Wot, Wot, Wot, Wot, Wot, Wot, Wot
Wot, Wot, Wwt, Wwt, Wwt, Wwt, Wwt, Wwt, Wwt, Wwr, Ww, Ww, Wwt, Wwt, Wwt, Wwt, Wwt, Wwt, Mm, Mm, Gll^Ftr, Gll^Ftr, Mm, Mm, Mm, Mm, Mm, Gll^Ftr, Gll^Ftr, Gll^Ftr, Wwt, Gll^Ftr, Gll^Ftr, Gll^Ftr, Gll^Ftr, Gll^Ftr, Gg^Em, Gll^Ftr, Gll^Ftr, Gll^Ftr, Gs^Ftp, Wwt, Gs^Ft, Gs^Ft, Gs^Ft, Gs^Ft, Gs^Ft, Gs^Ft, Gs^Ft, Ds, Ds, Ds, Wwt, Wwt, Wwt, Wwt, Wwt, Wwt, Wwt, Wwt, Wwt, Wwt, Wwt, Wwt, Wwt, Wwt, Wwt, Wot, Wot, Wot, Wot, Wot, Wot, Wot, Wot, Wot, Wot, Wot, Wot, Wot, Wot, Wot
Wot, Wwt, Wwt, Wwt, Wwt, Wwt, Ww, Ww, Ww, Ww, Wwt, Wwt, Wwt, Wwt, Mm, Ww, Mm, Mm, Mm, Mm, Wwr, Wwr, Wwrt, Mm, Mm, Mm, Mm, Mm, Mm, Gll^Ftr, Gll^Ftr, Wwt, Wwt, Gll^Ftr, Wwt, Rr^Vd, Gll^Ftr, Gll^Ftr, Gg, Gll^Ftr, Gg, Wwt, Wwt, Gs^Ft, Gs^Ft, Gs^Ft, Gs^Ft, Gs^Ft, Ds, Ds, Ds, Ds, Wwt, Wwt, Wwt, Wwt, Wwt, Wwt, Wwt, Wwt, Wwt, Wwt, Wwt, Wwt, Wwt, Wwt, Wot, Wot, Wot, Wot, Wot, Wot, Wot, Wot, Wot, Wot, Wot, Wot, Wot, Wot, Wot, Wot
Wwt, Wwt, Wwt, Wwt, Wwt, Wwt, Wwt, Wwt, Wwt, Wwt, Wwt, Wwt, Wwt, Mm, Mm, Mm, Mm, Mm, Mm, Mm, Mm, Gll^Ftr, Wwt, Gll^Ftr, Gll^Ftr, Mm, Mm, Mm, Mm, Gll^Ftr, Gll^Ftr, Gll^Ftr, Gll^Ftr, Wwt, Gll^Ftr, Wwt, Wwt, Gll^Ftr, Wwt, Gs^Ft, Gs^Ft, Gs^Ft, Gs^Ft, Wwt, Gs^Ft, Gs^Ft, Gs^Ft, Ds^Es, Ds, Ds, Wwt, Wwt, Wwt, Wwt, Wwt, Wwt, Wwt, Wwt, Wwt, Wwt, Wwt, Wwt, Wwt, Wwt, Wwt, Wwt, Wot, Wot, Wot, Wot, Wot, Wot, Wot, Wot, Wot, Wot, Wot, Wot, Wot, Wot, Wot, Wot
Wwt, Wwt, Wwt, Wwt, Wwt, Wwt, Wwt, Wwt, Wwt, Wwt, Wwt, Wwt, Wwt, Ww, Mm, Mm, Mm, Mm, Mm, Mm, Mm, Gll^Ftr, Gll^Ftr, Wwt, Wwt, Mm, Mm, Mm, Mm, Mm, Gll^Ftr, Gll^Ftr, Gll^Ftr, Gll^Ftr, Gll^Ftr, Gll^Ftr, Gll^Ftr, Wwt, Gll^Ftr, Wwt, Wwt, Gs^Ft, Gs^Ft, Wwt, Gs^Ft, Gs^Ft, Gs^Ft, Gs, Ds, Ds, Wwt, Wwt, Wwt, Wwt, Wwt, Wwt, Wwt, Wwt, Wwt, Wwt, Wwt, Wwt, Wwt, Wwt, Wwt, Wwt, Wot, Wot, Wot, Wot, Wot, Wot, Wot, Wot, Wot, Wot, Wot, Wot, Wot, Wot, Wot, Wot
Wwt, Wwt, Wwt, Wwt, Wwt, Wwt, Wwt, Wwt, Wwt, Wwt, Ww, Wwt, Wwt, Mm, Mm, Mm, Mm, Mm, Mm, Mm, Mm, Mm, Mm, Gll^Ftr, Wwt, Gll^Ftr, Gll^Ftr, Mm, Mm, Mm, Gll^Ftr, Gll^Ftr, Gg^Em, Gll^Ftr, Gll^Ftr, Gg, Gll^Ftr, Gll^Ftr, Gll^Ftr, Gll^Ftr, Gll^Ftr, Wwt, Gs^Ft, Wwt, Wwt, Gs^Ft, Dd^Ftd, Ds, Ds, Ds, Wwt, Wwt, Wwt, Wwt, Wwt, Wwt, Wwt, Wwt, Wwt, Wwt, Wwt, Wwt, Wwt, Wwt, Wwt, Wwt, Wot, Wot, Wot, Wot, Wot, Wot, Wot, Wot, Wot, Wot, Wot, Wot, Wot, Wot, Wot, Wot
Wwt, Wwt, Wwt, Wwt, Wwt, Wwt, Wwt, Wwt, Ww, Ww, Wwt, Wwt, Wwt, Wwt, Mm, Mm, Ww, Wwr, Mm, Mm, Mm, Mm, Mm, Gll^Ftr, Gll^Ftr, Wwt, Wwt, Gll^Ftr, Gll^Ftr, Gll^Ftr, Gll^Ftr, Gg^Em, Gll^Ftr, Gll^Ftr, Gll^Ftr, Gll^Ftr, Gll^Ftr, Gll^Ftr, Gll^Ftr, Gll^Ftr, Gg, Wwt, Gs^Ft, Gs^Ft, Wwt, Dd^Ftd, Dd^Do, Dd^Ftd, Ds, Ds, Ds, Wwt, Wwt, Wwt, Wwt, Wwt, Wwt, Wwt, Wwt, Wwt, Wwt, Wwt, Wwt, Wwt, Wwt, Wwt, Wot, Wot, Wot, Wot, Wot, Wot, Wot, Wot, Wot, Wot, Wot, Wot, Wot, Wot, Wot, Wot
Wwt, Wwt, Wwt, Wwt, Ww, Ww, Ww, Wwt, Wwt, Wwt, Wwt, Wwt, Ww, Ww, Ww, Mm, Mm, Ww, Mm, Mm, Mm, Mm, Mm, Gll^Ftr, Gll^Ftr, Rr^Vd, Wwt, Gll^Ftr, Gll^Ftr, Gll^Ftr, Gll^Ftr, Gll^Ftr, Gll^Ftr, Gg^Em, Gll^Ftr, Gll^Ftr, Gll^Ftr, Gll^Ftr, Gll^Ftr, Gll^Ftr, Gll^Ftr, Wwt, Wwt, Wwt, Gs^Ft, Gs^Ft, Gs^Ft, Dd^Ftd, Dd^Ftd, Ds, Ds, Wwt, Wwt, Wwt, Wwt, Wwt, Wwt, Wwt, Wwt, Wwt, Wwt, Wwt, Wwt, Wwt, Wwt, Wwt, Wwt, Wot, Wot, Wot, Wot, Wot, Wot, Wot, Wot, Wot, Wot, Wot, Wot, Wot, Wot, Wot
Wwt, Wwt, Wwt, Wwt, Wwt, Wwt, Wwt, Ww, Wwt, Wwt, Wwt, Wwt, Mm, Mm, Mm, Mm, Mv, Mm, Mm, Mm, Mm, Mm, Mm, Gll^Ftr, Gll^Ftr, Gll^Ftr, Gll^Ftr, Wwt, Wwt, Gll^Ftr, Gll^Ftr, Gll^Ftr, Gll^Ftr, Gll^Ftr, Gll^Ftr, Dd^Do, Gll^Ftr, Gll^Ftr, Gg, Gll^Ftr, Gll^Ftr, Wwt, Gs^Ft, Gs^Ft, Gs^Ft, Gs^Ft, Gs^Ft, Dd^Ftd, Gs^Ft, Ds, Ds, Ds, Wwt, Wwt, Wwt, Wwt, Wwt, Wwt, Wwt, Wwt, Wwt, Wwt, Wwt, Wwt, Wwt, Wwt, Wwt, Wot, Wot, Wot, Wot, Wot, Wot, Wot, Wot, Wot, Wot, Wot, Wot, Wot, Wot, Wot
Wwt, Wwt, Wwt, Wwt, Wwt, Wwt, Wwt, Wwt, Wwt, Wwt, Wwt, Wwt, Mm, Mm, Ur, Mv, Mv, Ur, Mm, Mm, Mm, Mm, Mm, Mm, Gll^Ftr, Gll^Ftr, Gll^Ftr, Gll^Ftr, Wwt, Gll^Ftr, Gll^Ftr, Gll^Ftr, Gll^Ftr, Gll^Ftr, Gll^Ftr, Gll^Ftr, Gg, Gll^Ftr, Gll^Ftr, Gll^Ftr, Gll^Ftr, Wwt, Gs^Ft, Gs^Ft, Gs^Ft, Gs^Ft, Gs^Ft, Gs^Ft, Gs^Ft, Ds^Esd, Ds, Ds, Wwt, Wwt, Wwt, Wwt, Wwt, Wwt, Wwt, Wwt, Wwt, Wwt, Wwt, Wwt, Wwt, Wwt, Wwt, Wot, Wot, Wot, Wot, Wot, Wot, Wot, Wot, Wot, Wot, Wot, Wot, Wot, Wot, Wot
Wwt, Wwt, Wwt, Wwt, Wwt, Wwt, Wwt, Wwt, Wwt, Wwt, Wwt, Wwt, Mm, Mm, Mm, Mm, Mm, Mm, Mm, Mm, Mm, Mm, Mm, Mm, Mm, Gll^Ftr, Gll^Ftr, Gll^Ftr, Gll^Ftr, Wwt, Wwt, Gg, Gll^Ftr, Gll^Ftr, Gll^Ftr, Gg, Gll^Ftr, Gll^Ftr, Gll^Ftr, Gll^Ftr, Gll^Ftr, Wwt, Wwt, Gs^Ft, Gs^Ft, Gs^Ft, Gs^Ft, Gs^Ft, Dd^Ftd, Gs^Ft, Ds, Ds, Ds, Wwt, Ds, Wwt, Wwt, Wwt, Wwt, Wwt, Wwt, Wwt, Wwt, Wwt, Wwt, Wwt, Wwt, Wwt, Wot, Wot, Wot, Wot, Wot, Wot, Wot, Wot, Wot, Wot, Wot, Wot, Wot, Wot
Wwt, Wwt, Wwt, Wwt, Wwt, Wwt, Ww, Wwt, Wwt, Wwt, Wwt, Wwt, Mm, Mm, Mm, Mm, Mm, Mm, Mm, Mm, Mm, Mm, Mm, Mm, Mm, Gll^Ftr, Gll^Ftr, Gll^Ftr, Gll^Ftr, Gll^Ftr, Gll^Ftr, Wwt, Wwt, Gll^Ftr, Gll^Ftr, Gll^Ftr, Gll^Ftr, Gll^Ftr, Gll^Ftr, Gll^Ftr, Gll^Ftr, Gll^Ftr, Wwt, Gs^Ft, Gs^Ft, Gs^Ft, Dd^Ftd, Ds, Gs^Ft, Ds, Dd^Ftd, Ds, Ds, Ds, Ds, Ds, Ds, Wwt, Wwt, Wwt, Wwt, Wwt, Wwt, Wwt, Wwt, Wwt, Wwt, Wwt, Wot, Wot, Wot, Wot, Wot, Wot, Wot, Wot, Wot, Wot, Wot, Wot, Wot, Wot
Wwt, Wwt, Wwt, Wwt, Wwt, Ww, Ww, Ww, Wwt, Wwt, Wwt, Wwt, Ww, Mm, Mm, Mm, Mm, Mm, Mm, Mm, Gll^Ftr, Gll^Ftr, Gll^Ftr, Mm, Hh^Ftr, Hh^Ftr, Gll^Ftr, Gll^Ftr, Gll^Ftr, Gll^Ftr, Gll^Ftr, Gll^Ftr, Gll^Ftr, Wwt, Wwt, Wwt, Wwt, Gll^Ftr, Wwt, Gll^Ftr, Gll^Ftr, Gg, Wwt, Gs^Ft, Gs^Ft, Gs^Ft, Gs^Ft, Gs^Ft, Gs^Ft, Gs^Ft, Gs^Ft, Gs, Gs^Ft, Ds, Ds, Ds^Esd, Ds, Wwt, Wwt, Wwt, Wwt, Wwt, Wwt, Wwt, Wwt, Wwt, Wwt, Wwt, Wwt, Wot, Wot, Wot, Wot, Wot, Wot, Wot, Wot, Wot, Wot, Wot, Wot, Wot
Wwt, Wwt, Wwt, Wwt, Wwt, Wwr, Ww, Ww, Ww, Wwt, Wwt, Wwt, Wwt, Ww, Mm, Mm, Mm, Mm, Mm, Mm, Gll^Ftr, Gll^Ftr, Wwt, Gll^Ftr, Ww^Ewf, Hh^Ftr, Gll^Ftr, Gg^Emf, Gll^Ftr, Gll^Ftr, Gll^Ftr, Gll^Ftr, Gll^Ftr, Gll^Ftr, Gll^Ftr, Gll^Ftr, Gll^Ftr, Wwt, Gg, Wwt, Wwt, Gll^Ftr, Gll^Ftr, Wwt, Gs^Ft, Gs^Ft, Gs^Ft, Gs^Ft, Gs^Ft, Ds, Gs^Ft, Gs^Ft, Gs^Ft, Gs^Ft, Dd^Ftd, Ds, Ds, Wwt, Ds, Wwt, Wwt, Wwt, Wwt, Wwt, Wwt, Wwt, Wwt, Wwt, Wwt, Wot, Wot, Wot, Wot, Wot, Wot, Wot, Wot, Wot, Wot, Wot, Wot, Wot
Wwt, Wwt, Wwt, Wwt, Wwt, Wwr, Ww, Ww, Ww, Wwt, Wwt, Wwt, Ww, Wwt, Wwt, Wwt, Mm, Mm, Mm, Gll^Ftr, Gll^Ftr, Ww^Ewl, Wot, Wwrt, Wwt, Gll^Ftr, Gll^Ftr, Gll^Ftr, Gs^Ftp, Gll^Ftr, Gs^Ftp, Gll^Ftr, Gs^Ftp, Gll^Ftr, Gg, Gs^Ft, Gs^Ft, Gll^Ftr, Gs^Ft, Gg, Gs^Ft, Wwt, Wwt, Wwt, Wwt, Gs^Ft, Wwt, Gs^Ft, Gs^Ft, Gs^Ft, Gs^Ft, Gs^Ft, Gs^Ft, Ds, Ds^Es, Ds, Ds, Ds, Ss, Ds, Ds, Ds, Wwt, Wwt, Wwt, Wwt, Wwt, Wwt, Wwt, Wot, Wot, Wot, Wot, Wot, Wot, Wot, Wot, Wot, Wot, Wot, Wot, Wot
Wwt, Wwt, Wwt, Wwt, Wwt, Wwr, Ww, Ww, Ww, Wwt, Wwt, Ww, Ww, Wwt, Wwt, Mm, Mm, Mm, Mm, Mm, Gll^Ftr, Wwt, Wot, Wot, Wwt, Wwt, Wwt, Gs^Ftp, Gs^Ftp, Gg, Gs^Ftp, Gs^Ftp, Gs^Ftp, Gs^Ftp, Gs^Ft, Gs^Ft, Gs^Ft, Gs^Ft, Gs^Ft, Gs^Ft, Gs^Ft, Gs^Ft, Gs^Ft, Gll^Ftr, Gs^Ft, Wwt, Gs^Ft, Wwt, Wwt, Gs^Ft, Wwt, Gs^Ft, Gs^Ft, Gs^Ft, Gs^Ft, Ds, Ds, Ss, Ds, Ds, Wwt, Wwt, Wwt, Wwt, Wwt, Wwt, Wwt, Wwt, Wwt, Wot, Wot, Wot, Wot, Wot, Wot, Wot, Wot, Wot, Wot, Wot, Wot, Wot
Wwt, Wwt, Wwt, Wwt, Wwt, Ww, Ww, Ww, Wwt, Wwt, Ww, Ww, Ww, Wwt, Wwt, Mm, Mm, Mm, Mm, Mm, Gll^Ftr, Wwt, Wwt, Wwt, Gll^Ftr, Gll^Ftr, Gll^Ftr, Wwt, Gs^Ftp, Gs^Ftp, Gs^Ftp, Gs^Ftp, Gs^Ft, Gs^Ft, Gs^Ft, Gs^Ft, Gs^Ft, Gs^Ft, Gs^Ft, Gs^Ft, Gs^Ft, Gs^Ft, Gs^Ft, Gs^Ft, Gs^Ft, Gs^Ft, Gs^Ft, Gs^Ft, Gs^Ft, Wwt, Dd^Ftd, Wwt, Wwt, Gs^Ft, Gs^Ft, Ss, Ss, Ss, Ds, Wwt, Wwt, Wwt, Wwt, Wwt, Wwt, Wwt, Wwt, Wwt, Wwt, Wot, Wot, Wot, Wot, Wot, Wot, Wot, Wot, Wot, Wot, Wot, Wot, Wot
Wwt, Wwt, Wwt, Wwt, Wwt, Ww, Ww, Ww, Ww, Ww, Ww, Ww, Ww, Wwt, Mm, Mm, Mm, Mm, Mm, Mm, Gll^Ftr, Gll^Ftr, Gll^Ftr, Gll^Ftr, Gll^Ftr, Gll^Ftr, Gs^Ftp, Wwt, Wwt, Gs^Ftp, Gs^Ft, Gg, Gs^Ft, Gs^Ft, Gs^Ft, Gs^Ft, Gs^Ft, Gs^Ft, Dd^Ftd, Gs^Ft, Gs^Ft, Gs^Ft, Gs^Ft, Gs^Ft, Gs^Ft, Gs^Ft, Gs^Ft, Gs^Ft, Gs^Ft, Gs^Ft, Gs^Ft, Dd^Ftd, Gs^Ft, Wwt, Wwt, Wwt, Wwt, Ss, Sm, Wwt, Wwt, Wwt, Wwt, Wwt, Wwt, Wwt, Wwt, Wwt, Wwt, Wot, Wot, Wot, Wot, Wot, Wot, Wot, Wot, Wot, Wot, Wot, Wot, Wot
Wwt, Wwt, Wwt, Wwt, Wwt, Wwr, Ww, Ww, Ww, Ww, Ww, Ww, Wwt, Wwt, Mm, Mm, Mm, Mm, Mm, Mm, Mm, Gll^Ftr, Gll^Ftr, Gll^Ftr, Gll^Ftr, Gg, Gg, Gll^Ftr, Gs^Ftp, Wwt, Wwt, Gg, Gs^Ft, Gs, Gs, Gs, Gs, Dd^Do, Gs^Ft, Dd^Ftd, Dd^Ftd, Gs^Ft, Gs^Ft, Gs^Ft, Gs^Ft, Gs^Ft, Gs^Ft, Gs^Ft, Gs^Ft, Gs^Ft, Gs^Ft, Gs^Ft, Gs^Ft, Gs^Ft, Ss, Wwrt, Ss, Wwt, Wwt, Wwt, Wwt, Wwt, Wwt, Wwt, Wwt, Wwt, Wwt, Wwt, Wwt, Wwt, Wot, Wot, Wot, Wot, Wot, Wot, Wot, Wot, Wot, Wot, Wot, Wot
Wwt, Wwt, Wwt, Wwt, Wwt, Ww, Wwr, Ww, Ww, Ww, Ww, Wwt, Wwt, Wwt, Mm, Mm, Mm, Mm, Mm, Mm, Mm, Mm, Mm, Gll^Ftr, Gs^Ftp, Gg, Gg, Gg, Rr^Vd, Gg, Gs^Ftp, Wwt, Wwt, Gs^Ft, Gg, Gs, Gs, Gs, Gs^Ft, Gs^Ft, Ds, Gs^Ft, Gg, Gs^Ft, Gg, Gs^Ft, Gs^Ft, Gs^Ft, Gs^Ft, Gs^Ft, Gs^Ft, Gs^Ft, Gs^Ft, Gs^Ft, Ss, Ss, Ss, Sm, Wwt, Wwt, Wwt, Wwt, Wwt, Wwt, Wwt, Wwt, Wwt, Wwt, Wwt, Wwt, Wwt, Wot, Wot, Wot, Wot, Wot, Wot, Wot, Wot, Wot, Wot, Wot
Wwt, Wwt, Wwt, Wwt, Wwt, Wwt, Wwt, Wwr, Ww, Ww, Wwt, Wwt, Ww, Wwt, Wwt, Mm, Mm, Mm, Mm, Mm, Mm, Mm, Mm, Gll^Ftr, Gs^Ftp, Gs^Ftp, Gg, Gs^Ftp, Ds, Gs^Ftp, Gs^Ftp, Gs^Ft, Gs^Ft, Wwt, Gg, Gs^Ft, Gs^Ft, Gs, Gs^Ft, Gs^Ft, Dd^Ftd, Gs^Ft, Gs^Ft, Gg, Gg, Gs^Ft, Gs^Ft, Gs^Ft, Dd^Ftd, Gs^Ft, Gs^Ft, Gs^Ft, Gs^Ft, Gs^Ft, Ds, Ss, Ds, Ds, Wwt, Wwt, Wwt, Wwt, Wwt, Wwt, Wwt, Wwt, Wwt, Wwt, Wwt, Wwt, Wot, Wot, Wot, Wot, Wot, Wot, Wot, Wot, Wot, Wot, Wot, Wot
Wwt, Wwt, Wwt, Ww, Ww, Ww, Ww, Wwt, Wwt, Wwt, Ww, Ww, Wwt, Wwt, Wwt, Mm, Mm, Mm, Mm, Mm, Mm, Mm, Mm, Gs^Ftp, Mm, Gs^Ftp, Gs^Ftp, Gg, Gg, Gg, Gg, Gs, Gg, Wwt, Wwt, Gs^Ft, Gs^Ft, Gs^Ft, Gs^Ft, Gs^Ft, Gs^Ft, Dd^Ftd, Dd^Ftd, Gs^Ft, Gs^Ft, Gs^Ft, Dd^Ftd, Ds, Ds, Dd^Ftd, Ds, Dd^Ftd, Dd^Ftd, Ds, Ds, Ds, Wwt, Wwt, Wwt, Wwt, Wwt, Wwt, Wwt, Wwt, Wwt, Wwt, Wwt, Wwt, Wwt, Wwt, Wwt, Wot, Wot, Wot, Wot, Wot, Wot, Wot, Wot, Wot, Wot, Wot
Wwt, Wwt, Wwt, Wwt, Ww, Wwt, Wwt, Wwt, Wwt, Wwt, Wwt, Wwt, Ww, Wwt, Mm, Mm, Mm, Mm, Mm, Mm, Mm, Mm, Mm, Mm, Mm, Mm, Gs^Ftp, Gs^Ftp, Gs^Ftp, Gg, Gs, Gs, Gs, Gg, Wwt, Wwt, Wwt, Gs^Ft, Gs^Ft, Gs^Ft, Gs, Dd^Ftd, Gs^Ftp, Ds, Dd^Ftd, Dd^Ftd, Dd^Ftd, Dd^Ftd, Gs^Ftp, Dd^Ftd, Dd^Ftd, Dd^Ftd, Dd^Ftd, Ds, Ds, Ds, Wwt, Wwt, Wwt, Wwt, Wwt, Wwt, Wwt, Wwt, Wwt, Wwt, Wwt, Wwt, Wwt, Wwt, Wot, Wot, Wot, Wot, Wot, Wot, Wot, Wot, Wot, Wot, Wot, Wot
Wwt, Wwt, Wwt, Ww, Wwt, Wwt, Wwt, Ww, Ww, Wwt, Wwt, Ww, Ur, Wwr, Mm, Mm, Mm, Mm, Mm, Mm, Mm, Mm, Mm, Mm, Mm, Mm, Hh^Ftp, Gs^Ftp, Gs^Ftp, Gg, Gs, Gs^Ftp, Gs, Gg, Wwt, Gs^Ft, Wwt, Gg, Gs^Ft, Gs^Ft, Gs, Gs, Gs^Ftp, Gs^Ftp, Gs^Ftp, Gs^Ftp, Gs^Ftp, Gs^Ftp, Gs^Ftp, Ds, Gs^Ftp, Gs, Gs, Ds, Ds, Ds, Wwt, Wwt, Wwt, Wwt, Wwt, Wwt, Wwt, Wwt, Wwt, Wwt, Wwt, Wwt, Wwt, Wwt, Wot, Wot, Wot, Wot, Wot, Wot, Wot, Wot, Wot, Wot, Wot, Wot
Wwt, Wwt, Wwt, Wwt, Wwr, Wwr, Ww, Wwt, Wwt, Wwt, Ww, Ur, Ur, Ur, Mv, Mm, Mm, Mm, Mm, Mm, Mm, Mm, Hh^Ftp, Mm, Gs, Hh^Ftp, Gs, Gs^Ftp, Gs^Ftp, Gs, Dd^Ftd, Gs, Gs, Gs^Ftp, Wwt, Gs^Ft, Gs^Ft, Wwt, Wwt, Gs^Ft, Gs, Gs^Ftp, Gs^Ftp, Gs^Ftp, Gs^Ftp, Gs^Ftp, Gs^Ftp, Gs^Ftp, Gs^Ftp, Gs^Ftp, Gs^Ftp, Dd^Ftd, Ds, Ds, Ds, Wwt, Wwt, Wwt, Wwt, Wwt, Wwt, Wwt, Wwt, Wwt, Wwt, Wwt, Wwt, Wwt, Wot, Wot, Wot, Wot, Wot, Wot, Wot, Wot, Wot, Wot, Wot, Wot, Wot, Wot
Wwt, Wwt, Wwt, Wwt, Ww, Ww, Ww, Wwt, Wwt, Wwt, Wwt, Ww, Ur, Mm, Mm, Mm, Mv, Mm, Mm, Mm, Mm, Mm, Gs, Hh^Ftd, Gs, Dd^Do, Gs, Gs, Gs, Gs, Ds, Rr^Vd, Gg, Gs^Ftp, Gs^Ft, Wwt, Wwt, Ww^Ewl, Wwt, Gg, Gg, Gs, Ds, Gs^Ftp, Gs^Ftp, Gs^Ftp, Gs^Ftp, Gs^Ftp, Gs^Ftp, Gs^Ftp, Gs, Ds, Ds, Ds, Wwt, Wwt, Wwt, Wwt, Wwt, Wwt, Wwt, Wwt, Wwt, Wwt, Wwt, Wwt, Wwt, Wwt, Wot, Wot, Wot, Wot, Wot, Wot, Wot, Wot, Wot, Wot, Wot, Wot, Wot, Wot
Wwt, Wwt, Wwt, Wwt, Wwr, Ww, Ww, Ww, Wwt, Wwt, Ww, Ur, Wwr, Ur, Ur, Mm, Mm, Mm, Mm, Mm, Dd^Ftd, Gs, Gs, Gs, Gs, Gs, Ds, Dd^Ftd, Gs, Gs, Gs, Gs, Gs^Ftp, Gs^Ftp, Gs^Ftp, Gs^Ftp, Gs^Ftp, Wwt, Gs^Ftp, Wwt, Wwt, Gg, Gg, Dd^Do, Gs^Ftp, Gs^Ftp, Ss, Gs^Ftp, Ss, Ss, Ds, Ds, Ds, Ds, Wwt, Wwt, Wwt, Wwt, Wwt, Wwt, Wwt, Wwt, Wwt, Wwt, Wwt, Wwt, Wwt, Wwt, Wot, Wot, Wot, Wot, Wot, Wot, Wot, Wot, Wot, Wot, Wot, Wot, Wot, Wot
Wwt, Wwt, Wwt, Wwt, Wwt, Wwr, Ww, Ww, Wwt, Wwt, Wwt, Ww, Wwt, Ww, Ww, Wwr, Ur, Mm, Mm, Mm, Mm, Gs, Mm, Mm, Mm, Dd^Ftd, Mm, Mm, Mm, Gs, Gs, Gs, Dd^Ftd, Gg, Gs^Ftp, Gs^Ftp, Gs^Ftp, Gs^Ftp, Gs^Ftp, Gs^Ftp, Gs^Ftp, Wwt, Wwt, Gs^Ftp, Gs^Ftp, Ss, Ss, Ss, Ss, Ds, Ss, Ss, Sm, Wwt, Wwt, Wwt, Wwt, Wwt, Wwt, Wwt, Wwt, Wwt, Wwt, Wwt, Wwt, Wwt, Wwt, Wwt, Wot, Wot, Wot, Wot, Wot, Wot, Wot, Wot, Wot, Wot, Wot, Wot, Wot, Wot
Wwt, Wwt, Wwt, Wwt, Wwt, Wwr, Ww, Ww, Ww, Wwt, Wwt, Wwt, Wwt, Wwt, Wwr, Ww, Ur, Ur, Mv, Mm, Mm, Mm, Mm, Mm, Mm, Mm, Mm, Mm, Mm, Ds, Ds, Gs, Gs, Gs, Gg, Gs^Ftp, Gs^Ftp, Gs^Ftp, Gs^Ftp, Gs^Ftp, Gs^Ftp, Gs^Ftp, Gs^Ftp, Wwt, Wwt, Sm, Ss, Ww^Ewl, Ss, Ss, Ds, Ds, Wwt, Wwt, Wwt, Wwt, Wwt, Wwt, Wwt, Wwt, Wwt, Wwt, Wwt, Wwt, Wwt, Wwt, Wwt, Wot, Wot, Wot, Wot, Wot, Wot, Wot, Wot, Wot, Wot, Wot, Wot, Wot, Wot, Wot
Wwt, Wwt, Wwt, Wwt, Wwt, Ww, Wwr, Ww, Ww, Wwt, Wwt, Wwt, Ww, Wwt, Ww, Ur, Ur, Mm, Mm, Mm, Mv, Mm, Mm, Mm, Mm, Mm, Mm, Mm, Mm, Dd^Ftd, Dd^Ftd, Gg, Gs^Ftp, Gs, Gg, Gs^Ftp, Gs^Ftp, Gs^Ftp, Ss, Gs^Ftp, Ss, Gs^Ftp, Ss, Gs^Ftp, Wwt, Sm, Ss, Ss, Sm, Sm, Ds, Ds, Dd^Ftd, Wwt, Wwt, Wwt, Wwt, Wwt, Wwt, Wwt, Wwt, Wwt, Wwt, Wwt, Wwt, Wwt, Wwt, Wot, Wot, Wot, Wot, Wot, Wot, Wot, Wot, Wot, Wot, Wot, Wot, Wot, Wot, Wot
Wwt, Wwt, Wwt, Wwt, Wwt, Wwt, Wwr, Ww, Ww, Wwt, Wwt, Wwt, Ww, Ww, Ww, Ur, Mm, Mv, Mm, Mv, Mm, Mm, Mm, Wwr, Wwr, Mm, Mm, Mm, Dd^Ftd, Dd^Ftd, Gs^Ftp, Gg, Gs^Ftp, Gg, Gs^Ftp, Dd^Do, Gs^Ftp, Gs^Ftp, Gs^Ftp, Ss, Ww^Ewl, Ss, Ss, Sm, Wwt, Sm, Ds, Ds, Wwt, Wwt, Wwt, Wwt, Wwt, Wwt, Wwt, Wwt, Wwt, Wwt, Wwt, Wwt, Wwt, Wwt, Wwt, Wwt, Wwt, Wwt, Wot, Wot, Wot, Wot, Wot, Wot, Wot, Wot, Wot, Wot, Wot, Wot, Wot, Wot, Wot, Wot
Wwt, Wwt, Wwt, Wwt, Wwt, Wwt, Wwr, Ww, Ww, Wwt, Wwt, Ww, Ww, Ww, Ww, Wwt, Mm, Mm, Mm, Mm, Mm, Mm, Mm, Mm, Wwr, Wwr, Wwr, Wwr, Dd^Ftd, Gs^Ftp, Gg, Gs^Ftp, Gs^Ftp, Gs^Ftp, Gs^Ftp, Gs^Ftp, Gs^Ftp, Gs^Ftp, Ss, Ss, Ss, Ss, Ss, Sm, Wwt, Ds, Wwt, Wwt, Wwt, Wwt, Wwt, Wwt, Wwt, Wwt, Wwt, Wwt, Wwt, Wwt, Wwt, Wwt, Wwt, Wwt, Wwt, Wwt, Wwt, Wot, Wot, Wot, Wot, Wot, Wot, Wot, Wot, Wot, Wot, Wot, Wot, Wot, Wot, Wot, Wot, Wot
Wwt, Wwt, Wwt, Wwt, Wwt, Wwt, Wwt, Ww, Wwt, Wwt, Wwt, Wwt, Wwt, Wwt, Wwt, Wwt, Mm, Mm, Mm, Mm, Mm, Mm, Mm, Wwr, Wwr, Ww, Ww, Ww, Wwt, Dd^Ftd, Gs^Ftp, Gs^Ftp, Gs^Ftp, Gs^Ftp, Ds, Ss, Ss, Ss, Ss, Ww^Ewf, Ss, Ss, Ss, Ds, Wwt, Wwt, Wwt, Wwt, Wwt, Wwt, Wwt, Wwt, Wwt, Wwt, Wwt, Wwt, Wwt, Wwt, Wwt, Wwt, Wwt, Wwt, Wwt, Wwt, Wot, Wot, Wot, Wot, Wot, Wot, Wot, Wot, Wot, Wot, Wot, Wot, Wot, Wot, Wot, Wot, Wot, Wot
Wwt, Wwt, Wwt, Wwt, Wwt, Wwt, Wwt, Wwt, Wwt, Wwt, Ww, Wwt, Wwt, Wwt, Wwt, Wwt, Wwt, Mm, Mm, Mm, Mm, Mm, Mm, Wwr, Wwr, Wwr, Ww, Wwt, Dd^Ftd, Dd^Ftd, Ds, Gs^Ftp, Gs^Ftp, Dd^Ftd, Ds, Ds, Ds, Ds, Ds, Ss, Ds, Sm, Ds, Ds, Wwt, Wwt, Wwt, Wwt, Wwt, Wwt, Wwt, Wwt, Wwt, Wwt, Wwt, Wwt, Wwt, Wwt, Wwt, Wwt, Wwt, Wwt, Wwt, Wwt, Wot, Wot, Wot, Wot, Wot, Wot, Wot, Wot, Wot, Wot, Wot, Wot, Wot, Wot, Wot, Wot, Wot, Wot
Wwt, Wwt, Wwt, Wwt, Wwt, Wwt, Wwt, Wwt, Wwt, Ww, Wwt, Wwt, Wwt, Ww, Ww, Wwt, Wwt, Wwt, Mm, Mm, Mm, Mm, Mm, Ww, Ww, Wwr, Wwr, Wwt, Dd^Ftd, Ds, Dd^Ftd, Dd^Ftd, Ds, Ds, Ds, Ds, Ds, Dd^Ftd, Ds, Ds, Wwt, Ds, Wwt, Wwt, Wwt, Wwt, Wwt, Wwt, Wwt, Wwt, Wwt, Wwt, Wwt, Wwt, Wwt, Wwt, Wwt, Wwt, Wwt, Wwt, Wwt, Wwt, Wwt, Wwt, Wot, Wot, Wot, Wot, Wot, Wot, Wot, Wot, Wot, Wot, Wot, Wot, Wot, Wot, Wot, Wot, Wot, Wot
Wwt, Wwt, Wwt, Wwt, Wwt, Wwt, Wwt, Wwt, Ww, Wwt, Wwt, Ww, Wwt, Wwt, Ww, Ww, Wwt, Wwt, Wwt, Mm, Mm, Mm, Mm, Mm, Mm, Wwr, Ww, Wwt, Dd^Ftd, Dd^Ftd, Wwt, Dd^Ftd, Ds, Wwt, Wwt, Wwt, Wwt, Ds, Wwt, Wwt, Wwt, Wwt, Wwt, Wwt, Wwt, Wwt, Wwt, Wwt, Wwt, Wwt, Wwt, Wwt, Wwt, Wwt, Wwt, Wwt, Wwt, Wwt, Wwt, Wwt, Wwt, Wwt, Wwt, Wot, Wot, Wot, Wot, Wot, Wot, Wot, Wot, Wot, Wot, Wot, Wot, Wot, Wot, Wot, Wot, Wot, Wot, Wot
Wot, Wwt, Wwt, Wwt, Wwt, Wwt, Wwt, Wwr, Ww, Ww, Ww, Wwt, Wwt, Wwt, Wwt, Wwt, Ww, Wwt, Wwt, Wwt, Mm, Mm, Mm, Mm, Mm, Wwr, Wwr, Wwt, Wwt, Dd^Ftd, Dd^Ftd, Wwt, Wwt, Wwt, Wwt, Wwt, Wwt, Wwt, Wwt, Wwt, Wwt, Wwt, Wwt, Wwt, Wwt, Wwt, Wwt, Wwt, Wwt, Wwt, Wwt, Wwt, Wwt, Wwt, Wwt, Wwt, Wwt, Wwt, Wwt, Wwt, Wwt, Wwt, Wwt, Wot, Wot, Wot, Wot, Wot, Wot, Wot, Wot, Wot, Wot, Wot, Wot, Wot, Wot, Wot, Wot, Wot, Wot, Wot
Wot, Wot, Wwt, Wwt, Wwt, Wwt, Wwt, Wwr, Wwr, Ww, Ww, Ww, Ww, Wwt, Wwt, Wwt, Wwt, Ww, Wwt, Wwt, Wwt, Mm, Mm, Mm, Mm, Mm, Mm, Ww, Ww, Wwt, Wwt, Wwt, Wwt, Wwt, Wwt, Wwt, Wwt, Wwt, Wwt, Wwt, Wwt, Wwt, Wwt, Wwt, Wwt, Wwt, Wwt, Wwt, Wwt, Wwt, Wwt, Wwt, Wwt, Wwt, Wwt, Wwt, Wwt, Wwt, Wwt, Wwt, Wwt, Wwt, Wot, Wot, Wot, Wot, Wot, Wot, Wot, Wot, Wot, Wot, Wot, Wot, Wot, Wot, Wot, Wot, Wot, Wot, Wot, Wot
Wot, Wot, Wot, Wwt, Wwt, Wwt, Wwt, Wwt, Ww, Ww, Ww, Ww, Ww, Ww, Wwt, Wwt, Wwt, Ww, Wwt, Wwt, Wwt, Wwt, Wwt, Mm, Mm, Mm, Mm, Ww, Ww, Wwt, Ww, Wwt, Wwt, Wwt, Wwt, Wwt, Wwt, Wwt, Wwt, Wwt, Wwt, Wwt, Wwt, Wwt, Wwt, Wwt, Wwt, Wwt, Wwt, Wwt, Wwt, Wwt, Wwt, Wwt, Wwt, Wwt, Wwt, Wwt, Wwt, Wwt, Wot, Wot, Wot, Wot, Wot, Wot, Wot, Wot, Wot, Wot, Wot, Wot, Wot, Wot, Wot, Wot, Wot, Wot, Wot, Wot, Wot, Wot
Wot, Wot, Wot, Wwt, Wwt, Wwt, Wwt, Wwt, Wwt, Wwr, Wwr, Ww, Ww, Ww, Ww, Ww, Ww, Wwt, Wwt, Wwt, Wwt, Wwt, Wwt, Wwt, Wwt, Mm, Mm, Ww, Wwt, Wwt, Wwt, Ww, Wwt, Wwt, Wwt, Wwt, Wwt, Wwt, Wwt, Wwt, Wwt, Wwt, Wwt, Wwt, Wwt, Wwt, Wwt, Wwt, Wwt, Wwt, Wwt, Wwt, Wwt, Wwt, Wwt, Wwt, Wwt, Wwt, Wot, Wot, Wot, Wot, Wot, Wot, Wot, Wot, Wot, Wot, Wot, Wot, Wot, Wot, Wot, Wot, Wot, Wot, Wot, Wot, Wot, Wot, Wot, Wot
Wot, Wot, Wot, Wwt, Wwt, Wwt, Wwt, Wwt, Wwt, Wwt, Wwt, Ww, Wwr, Ww, Ww, Ww, Ww, Ww, Wwt, Wwt, Wwt, Wwt, Wwt, Wwt, Wwt, Wwt, Wwt, Ww, Ww, Wwt, Ww, Wwt, Wwt, Wwt, Wwt, Wwt, Wwt, Wwt, Wwt, Wwt, Wwt, Wwt, Wwt, Wwt, Wwt, Wwt, Wwt, Wwt, Wwt, Wwt, Wwt, Wwt, Wwt, Wwt, Wwt, Wwt, Wwt, Wot, Wot, Wot, Wot, Wot, Wot, Wot, Wot, Wot, Wot, Wot, Wot, Wot, Wot, Wot, Wot, Wot, Wot, Wot, Wot, Wot, Wot, Wot, Wot, Wot
Wot, Wot, Wot, Wwt, Wwt, Wwt, Wwt, Wwt, Wwt, Wwt, Wwt, Wwt, Wwt, Wwr, Wwr, Ww, Ww, Ww, Wwt, Wwt, Wwt, Wwt, Wwt, Wwt, Wwt, Wwt, Wwt, Wwt, Wwt, Ww, Wwt, Wwt, Wwt, Wwt, Wwt, Wwt, Wwt, Wwt, Wwt, Wwt, Wwt, Wwt, Wwt, Wwt, Wwt, Wwt, Wwt, Wwt, Wwt, Wwt, Wwt, Wwt, Wwt, Wwt, Wwt, Wwt, Wot, Wot, Wot, Wot, Wot, Wot, Wot, Wot, Wot, Wot, Wot, Wot, Wot, Wot, Wot, Wot, Wot, Wot, Wot, Wot, Wot, Wot, Wot, Wot, Wot, Wot
Wot, Wot, Wot, Wot, Wot, Wwt, Wwt, Wwt, Wwt, Wwt, Wwt, Wwt, Wwt, Wwt, Wwt, Wwt, Wwt, Wwt, Wwt, Wwt, Wwt, Wwt, Wwt, Wwt, Wwt, Wwt, Wwt, Wwt, Wwt, Wwt, Wwt, Wwt, Wwt, Wwt, Wwt, Wwt, Wwt, Wwt, Wwt, Wwt, Wwt, Wwt, Wwt, Wwt, Wwt, Wwt, Wwt, Wwt, Wwt, Wwt, Wwt, Wwt, Wot, Wot, Wot, Wot, Wot, Wot, Wot, Wot, Wot, Wot, Wot, Wot, Wot, Wot, Wot, Wot, Wot, Wot, Wot, Wot, Wot, Wot, Wot, Wot, Wot, Wot, Wot, Wot, Wot, Wot
Wot, Wot, Wot, Wot, Wot, Wwt, Wwt, Wwt, Wwt, Wwt, Wwt, Wwt, Wwt, Wwt, Wwt, Wwt, Wwt, Wwt, Wwt, Wwt, Wwt, Wwt, Wwt, Wwt, Wwt, Wwt, Wwt, Wwt, Wwt, Wwt, Wwt, Wwt, Wwt, Wwt, Wwt, Wwt, Wwt, Wwt, Wwt, Wwt, Wwt, Wwt, Wwt, Wwt, Wwt, Wwt, Wot, Wwt, Wot, Wwt, Wot, Wot, Wot, Wot, Wot, Wot, Wot, Wot, Wot, Wot, Wot, Wot, Wot, Wot, Wot, Wot, Wot, Wot, Wot, Wot, Wot, Wot, Wot, Wot, Wot, Wot, Wot, Wot, Wot, Wot, Wot, Wot
Wot, Wot, Wot, Wot, 1 Wot, Wot, Wot, Wwt, Wwt, Wwt, Wwt, Wwt, Wwt, Wwt, Wwt, Wwt, Wwt, Wwt, Wwt, Wwt, Wwt, Wwt, Wwt, Wwt, Wwt, Wwt, Wwt, Wwt, Wwt, Wwt, Wwt, Wwt, Wot, Wwt, Wwt, Wwt, Wwt, Wwt, Wwt, Wwt, Wwt, Wwt, Wot, Wwt, Wot, Wot, Wot, Wot, Wot, Wot, Wot, Wot, Wot, Wot, Wot, Wot, Wot, Wot, Wot, Wot, Wot, Wot, Wot, Wot, Wot, Wot, Wot, Wot, Wot, Wot, Wot, Wot, Wot, Wot, Wot, Wot, Wot, Wot, Wot, Wot, Wot, Wot
Wot, Wot, Wot, Wot, Wot, Wot, Wot, Wot, Wot, Wot, Wot, Wwt, Wwt, Wwt, Wwt, Wwt, Wwt, Wwt, Wwt, Wwt, Wot, Wwt, Wot, Wwt, Wwt, Wwt, Wot, Wwt, Wot, Wwt, Wot, Wot, Wot, Wot, Wot, Wwt, Wwt, Wwt, Wot, Wwt, Wot, Wot, Wot, Wot, Wot, Wot, Wot, Wot, Wot, Wot, Wot, Wot, Wot, Wot, Wot, Wot, Wot, Wot, Wot, Wot, Wot, Wot, Wot, Wot, Wot, Wot, Wot, Wot, Wot, Wot, Wot, Wot, Wot, Wot, Wot, Wot, Wot, Wot, Wot, Wot, Wot, Wot
Wot, Wot, Wot, Wot, Wot, Wot, Wot, Wot, Wot, Wot, Wot, Wot, Wot, Wot, Wot, Wwt, Wot, Wwt, Wot, Wot, Wot, Wot, Wot, Wot, Wot, Wot, Wot, Wot, Wot, Wot, Wot, Wot, Wot, Wot, Wot, Wot, Wot, Wot, Wot, Wot, Wot, Wot, Wot, Wot, Wot, Wot, Wot, Wot, Wot, Wot, Wot, Wot, Wot, Wot, Wot, Wot, Wot, Wot, Wot, Wot, Wot, Wot, Wot, Wot, Wot, Wot, Wot, Wot, Wot, Wot, Wot, Wot, Wot, Wot, Wot, Wot, Wot, Wot, Wot, Wot, Wot, Wot
Wot, Wot, Wot, Wot, Wot, Wot, Wot, Wot, Wot, Wot, Wot, Wot, Wot, Wot, Wot, Wot, Wot, Wot, Wot, Wot, Wot, Wot, Wot, Wot, Wot, Wot, Wot, Wot, Wot, Wot, Wot, Wot, Wot, Wot, Wot, Wot, Wot, Wot, Wot, Wot, Wot, Wot, Wot, Wot, Wot, Wot, Wot, Wot, Wot, Wot, Wot, Wot, Wot, Wot, Wot, Wot, Wot, Wot, Wot, Wot, Wot, Wot, Wot, Wot, Wot, Wot, Wot, Wot, Wot, Wot, Wot, Wot, Wot, Wot, Wot, Wot, Wot, Wot, Wot, Wot, Wot, Wot
Wot, Wot, Wot, Wot, Wot, Wot, Wot, Wot, Wot, Wot, Wot, Wot, Wot, Wot, Wot, Wot, Wot, Wot, Wot, Wot, Wot, Wot, Wot, Wot, Wot, Wot, Wot, Wot, Wot, Wot, Wot, Wot, Wot, Wot, Wot, Wot, Wot, Wot, Wot, Wot, Wot, Wot, Wot, Wot, Wot, Wot, Wot, Wot, Wot, Wot, Wot, Wot, Wot, Wot, Wot, Wot, Wot, Wot, Wot, Wot, Wot, Wot, Wot, Wot, Wot, Wot, Wot, Wot, Wot, Wot, Wot, Wot, Wot, Wot, Wot, Wot, Wot, Wot, Wot, Wot, Wot, Wot
