Wot, Wot, Wot, Wot, Wot, Wot, Wot, Wot, Wot, Wot, Wot, Wot, Wot, Wot, Wot, Wot, Wot, Wot, Wot, Wwt, Wot, Wot, Wot, Wot, Wot, Wot, Wot, Wot, Wwt, Wwt, Wwt, Wwt, Wwt, Wwt, Wwt, Wwt, Wwt, Wwt, Wwt, Wwt, Wwt, Wwt, Wwt, Wwt, Wwt, Wwt, Wwt, Wwt, Wwt, Wwt, Wwt, Wwt, Wwt, Wwt, Wwt, Wwt, Wwt, Wwt, Wwt, Wwt, Wwt, Wwt, Wwt, Wwt, Wwt, Wwt, Wwt, Wwt, Wwt, Wwt, Wot, Wot, Wot, Wot, Wot, Wot, Wot, Wot, Wot, Wot, Wot, Wot
Wot, Wot, Wot, Wot, Wot, Wot, Wot, Wot, Wot, Wot, Wot, Wot, Wot, Wot, Wot, Wot, Wot, Wot, Wot, Wot, Wot, Wot, Wwt, Wot, Wwt, Wot, Wwt, Wwt, Wwt, Wwt, Wwt, Wwt, Wwt, Wwt, Wwt, Wwt, Wwt, Wwt, Wwt, Wwt, Wwt, Wwt, Wwt, Wwt, Ww, Wwt, Wwt, Wwt, Wwt, Wwt, Wwt, Wwt, Wwt, Wwt, Wwt, Wwt, Wwt, Wwt, Wwt, Wwt, Wwt, Wwt, Wwrt, Wwt, Wwt, Wwt, Wwt, Wwt, Wwt, Wwt, Wwt, Wot, Wot, Wot, Wot, Wot, Wot, Wot, Wot, Wot, Wot, Wot
Wot, Wot, Wot, Wot, Wot, Wot, Wot, Wot, Wot, Wot, Wot, Wot, Wot, Wot, Wot, Wot, Wot, Wot, Wot, Wot, Wwt, Wwt, Wwt, Wwt, Wwt, Wwt, Wwt, Wwt, Wwt, Wwt, Wwt, Wwt, Wwt, Wwt, Ww, Wwt, Wwt, Ww, Ww, Ww, Ww, Wwt, Wwt, Wwt, Ww, Ww, Wwt, Wwt, Wwt, Wwt, Wwt, Wwt, Wwt, Wwt, Wwt, Wwt, Wwt, Wwt, Wwt, Wwt, Wwt, Wwrt, Mm, Wwt, Wwt, Wwt, Mm, Wwt, Wwt, Wwt, Wwt, Wwt, Wot, Wot, Wot, Wot, Wot, Wot, Wot, Wot, Wot, Wot
Wot, Wot, Wot, Wot, Wot, Wot, Wot, Wot, Wot, Wot, Wot, Wot, Wot, Wot, Wot, Wot, Wot, Wot, Wwt, Wwt, Wwt, Wwt, Wwt, Wwt, Ww, Wwt, Ww, Wwt, Wwt, Wwt, Wwt, Wwt, Wwt, Wwt, Wwt, Ww, Wwt, Wwt, Wwt, Ww, Ww, Wwt, Wwt, Wwt, Wwt, Wwt, Wwt, Wwt, Mm, Wwt, Mm, Wwt, Mm, Wwt, Mm, Wwrt, Mm, Wwt, Wwrt, Wwrt, Wwr, Mm, Mm, Mm, Mm, Mm, Mm, Wwt, Wwt, Wwt, Wwt, Wwt, Wot, Wot, Wot, Wot, Wot, Wot, Wot, Wot, Wot, Wot
Wot, Wot, Wot, Wot, Wot, Wot, Wot, Wot, Wot, Wot, Wot, Wot, Wot, Wot, Wwt, Wwt, Wwt, Wwt, Wwt, Wwt, Mm, Mm, Mm, Wwt, Wwt, Ww, Ww, Ww, Ww, Wwt, Wwt, Wwt, Mm, Wwt, Mm, Wwt, Wwt, Wwt, Wwt, Wwt, Ww, Wwt, Wwt, Wwt, Wwt, Wwt, Mm, Mm, Mm, Mm, Gll^Ftr, Mm, Mm, Mm, Mm, Mm, Mm, Mm, Mm, Wwr, Wwrt, Mm, Mm, Mm, Mm, Mm, Wwt, Wwt, Wwt, Wwt, Wwt, Wwt, Wot, Wot, Wot, Wot, Wot, Wot, Wot, Wot, Wot, Wot
Wot, Wot, Wot, Wot, Wot, Wot, Wot, Wot, Wot, Wot, Wot, Wot, Wot, Wot, Wwt, Wwt, Wwt, Wwt, Mm, Mm, Mm, Mm, Mm, Wwr, Wwr, Wwt, Wwt, Ww, Ww, Wwt, Wwt, Mm, Mm, Mm, Mm, Mm, Mm, Mm, Mm, Wwt, Wwt, Wwt, Mm, Mm, Mm, Mm, Mm, Mm, Mm, Mm, Gll^Ftr, Gll^Ftr, Mm, Mm, Mm, Mm, Mm, Mm, Mm, Wwr, Wwt, Wwrt, Wwt, Wwt, Wwt, Wwt, Wwt, Wwt, Wwt, Wwt, Wwt, Wot, Wot, Wot, Wot, Wot, Wot, Wot, Wot, Wot, Wot, Wot
Wot, Wot, Wot, Wot, Wot, Wot, Wot, Wot, Wot, Wot, Wot, Wot, Wot, Wwt, Ww, Wwt, Wwt, Wwt, Wwt, Mm, Wwt, Wwt, Mm, Mm, Mm, Wwt, Wwt, Ww, Wwt, Wwt, Wwt, Mm, Mm, Mm, Mm, Mm, Mm, Mm, Mm, Wwt, Mm, Mm, Mm, Mm, Mm, Mm, Mm, Mm, Mm, Mm, Gll^Ftr, Mm, Gs^Ft, Mm, Gs^Ft, Gs^Ft, Dd^Ftd, Mm, Wwrt, Wwrt, Wwt, Wwt, Wwt, Wwt, Wwt, Wwt, Wwt, Wwt, Wwt, Wwt, Wot, Wot, Wot, Wot, Wot, Wot, Wot, Wot, Wot, Wot, Wot, Wot
Wot, Wot, Wot, Wot, Wot, Wot, Wot, Wot, Wot, Wot, Wot, Wot, Wot, Ww, Wwt, Wwt, Wwt, Wwt, Wwt, Wwt, Wwt, Mm, Wwr, Mm, Mm, Mm, Mm, Wwt, Wwt, Wwt, Wwr, Wwr, Mm, Mm, Uh, Mm, Mm, Mm, Mm, Mm, Mm, Mm, Mm, Mm, Gll^Ftr, Mm, Gll^Ftr, Mm, Gll^Ftr, Gll^Ftr, Gs, Gs^Ft, Gs^Ft, Gs^Ft, Gs, Gs, Ds, Dd^Ftd, Wwrt, Wwt, Wwt, Wwt, Wwt, Wwt, Wwt, Wwt, Wwt, Wwt, Wwt, Wot, Wot, Wot, Wot, Wot, Wot, Wot, Wot, Wot, Wot, Wot, Wot, Wot
Wot, Wot, Wot, Wot, Wot, Wot, Wot, Wot, Wot, Wot, Wot, Wot, Wot, Wwt, Wwt, Wwt, Ww, Wwt, Wwt, Wwt, Wwt, Wwt, Wwr, Wwt, Wwt, Mm, Mm, Mm, Wwr, Wwr, Mm, Mm, Uh, Ur, Ql, Uh, Ur, Mm, Mm, Mm, Mm, Mm, Gll^Ftr, Gll^Ftr, Gll^Ftr, Gll^Ftr, Gs^Ft, Gll^Ftr, Gs^Ft, Gs^Ft, Gs^Ft, Dd^Do, Gs^Ft, Gs^Ft, Ds, Ds, Ds, Ds, Wwt, Wwt, Wwt, Wwt, Wwt, Wwt, Wwt, Wwt, Wwt, Wwt, Wot, Wot, Wot, Wot, Wot, Wot, Wot, Wot, Wot, Wot, Wot, Wot, Wot, Wot
Wot, Wot, Wot, Wot, Wot, Wot, Wot, Wot, Wot, Wot, Wot, Wot, Wwt, Wwt, Wwt, Wwt, Ww, Wwt, Wwt, Wwt, Wwt, Wwt, Mm, Mm, Mm, Wwt, Wwt, Mm, Wwr, Mm, Mm, Mm, Uh, Ql, Ql, Ql, Uh, Mm, Mm, Mm, Gll^Ftr, Gll^Ftr, Gll^Ftr, Gll^Ftr, Gs^Ft, Gs^Ft, Gs^Ft, Gs^Ft, Dd, Dd, Gs, Gs^Ft, Gs^Ft, Dd^Ftd, Ds, Ds, Wwt, Wwt, Wwt, Wwt, Wwt, Wwt, Wwt, Wwt, Wwt, Wwt, Wwt, Wot, Wot, Wot, Wot, Wot, Wot, Wot, Wot, Wot, Wot, Wot, Wot, Wot, Wot, Wot
Wot, Wot, Wot, Wot, Wot, Wot, Wot, Wot, Wot, Wot, Wwt, Wwt, Wwt, Wwt, Wwt, Wwr, Ww, Ww, Ww, Wwt, Wwt, Mm, Mm, Wwt, Wwt, Mm, Wwr, Wwr, Mm, Mm, Mm, Mm, Ur, Uh, Ur, Uh, Mm, Mm, Mm, Mm, Gll^Ftr, Gll^Ftr, Gll^Ftr, Gs^Ft, Gs^Ft, Gs^Ft, Dd, Gs^Ft, Dd^Dc, Dd^Ftd, Gs^Ft, Gs^Ft, Dd^Ftd, Ds, Ds, Ds, Ds, Wwt, Wwt, Wwt, Wwt, Wwt, Wwt, Wwt, Wwt, Wwt, Wwt, Wot, Wot, Wot, Wot, Wot, Wot, Wot, Wot, Wot, Wot, Wot, Wot, Wot, Wot, Wot
Wot, Wot, Wot, Wot, Wot, Wot, Wot, Wot, Wwt, Wwt, Wwt, Wwt, Wwt, Wwt, Wwt, Wwr, Ww, Ww, Wwt, Wwt, Wwt, Mm, Mm, Mm, Mm, Wwr, Mm, Mm, Mm, Mm, Mm, Gll^Ftr, Mm, Ur, Mm, Mm, Mm, Mm, Gll^Ftr, Gll^Ftr, Gll^Ftr, Gll^Ftr, Gs^Ft, Gs^Ft, Gs, Gs^Ft, Gs^Ft, Dd, Dd, Dd, Gs^Ft, Dd^Ftd, Gs^Ft, Gs, Ds, Ds^Edb, Ds, Wwt, Wwt, Wwt, Wwt, Wwt, Wwt, Wwt, Wwt, Wwt, Wwt, Wot, Wot, Wot, Wot, Wot, Wot, Wot, Wot, Wot, Wot, Wot, Wot, Wot, Wot, Wot
Wot, Wot, Wot, Wot, Wot, Wot, Wwt, Wwt, Wwt, Wwt, Wwt, Wwt, Wwr, Wwt, Wwt, Ww, Ww, Ww, Ww, Ww, Wwt, Mm, Mm, Mm, Mm, Mm, Mm, Mm, Mm, Mm, Gll^Ftr, Gll^Ftr, Mm, Mm, Mm, Mm, Mm, Mm, Gll^Ftr, Gll^Ftr, Gs^Ft, Gs^Ft, Gs^Ft, Gs, Gs^Ft, Gs^Ft, Gs^Ft, Gs^Ft, Gs^Ft, Gs^Ft, Gs^Ft, Gs^Ft, Gs^Ft, Gs^Ft, Ds, Ds, Ds, Wwt, Wwt, Wwt, Wwt, Wwt, Wwt, Wwt, Wwt, Wwt, Wot, Wot, Wot, Wot, Wot, Wot, Wot, Wot, Wot, Wot, Wot, Wot, Wot, Wot, Wot, Wot
Wot, Wot, Wot, Wot, Wot, Wwt, Wwt, Wwt, Wwt, Wwt, Wwt, Wwr, Ww, Ww, Ww, Ww, Ww, Ww, Wwt, Wwt, Wwt, Mm, Mm, Mm, Mm, Mm, Mm, Mm, Gll^Ftr, Gll^Ftr, Mm, Mm, Mm, Mm, Mm, Mm, Mm, Mm, Gll^Ftr, Gll^Ftr, Gs^Ft, Gs^Ft, Gs, Gs^Ft, Gs^Ft, Gs^Ft, Gs^Ft, Gs^Ft, Dd^Ftd, Dd^Ftd, Dd^Ftd, Gs^Ft, Gs, Ds, Ds, Ds, Ds, Wwt, Wwt, Wwt, Wwt, Wwt, Wwt, Wwt, Wwt, Wwt, Wot, Wot, Wot, Wot, Wot, Wot, Wot, Wot, Wot, Wot, Wot, Wot, Wot, Wot, Wot, Wot
Wot, Wot, Wot, Wot, Wwt, Wwt, Wwt, Wwt, Wwt, Wwt, Wwt, Wwr, Ww, Ww, Ww, Ww, Ww, Ww, Wwt, Wwt, Wwt, Wwt, Mm, Mm, Mm, Mm, Mm, Gll^Ftr, Gll^Ftr, Gs^Ftp, Mm, Mm, Mm, Mm, Mm, Wwrt, Gll^Ftr, Gll^Ftr, Gll^Ftr, Gs^Ft, Gs^Ft, Dd^Do, Gs^Ft, Gs^Ft, Gs^Ft, Gs^Ft, Dd^Ftd, Gs^Ft, Dd^Ftd, Dd^Ftd, Ds, Ds, Ds, Ds, Ds, Ds, Wwt, Wwt, Wwt, Wwt, Wwt, Wwt, Wwt, Wwt, Wwt, Wwt, Wot, Wot, Wot, Wot, Wot, Wot, Wot, Wot, Wot, Wot, Wot, Wot, Wot, Wot, Wot, Wot
Wot, Wot, Wot, Wot, Wwt, Wwt, Wwt, Wwt, Wwt, Wwt, Wwt, Ww, Ww, Ww, Wwt, Ww, Wwt, Wwt, Wwt, Wwt, Mm, Mm, Mm, Mm, Mm, Mm, Gll^Ftr, Gll^Ftr, Ww^Ewf, Gll^Ftr, Gll^Ftr, Mm, Mm, Mm, Mm, Wwrt, Wwt, Gll^Ftr, Gs^Ft, Gs^Ft, Gs^Ft, Gs^Ft, Gs^Ft, Gs^Ft, Gs^Ft, Dd^Ftd, Gs^Ft, Dd^Ftd, Dd^Ftd, Gs^Ftp, Ds, Ds, Ds, Ds, Wwt, Wwt, Wwt, Wwt, Wwt, Wwt, Wwt, Wwt, Wwt, Wwt, Wwt, Wwt, Wot, Wot, Wot, Wot, Wot, Wot, Wot, Wot, Wot, Wot, Wot, Wot, Wot, Wot, Wot, Wot
Wot, Wot, Wot, Wwt, Wwt, Wwt, Wwt, Wwt, Wwt, Wwt, Wwt, Wwr, Ww, Ww, Wwt, Wwt, Wwt, Wwt, Mm, Mm, Mm, Mm, Gll^Ftr, Mm, Gll^Ftr, Gll^Ftr, Gll^Ftr, Ww^Ewl, Rr^Vd, Ww^Ewl, Gll^Ftr, Gll^Ftr, Mm, Mm, Mm, Gll^Ftr, Gll^Ftr, Wwt, Wwt, Gs^Ft, Gs^Ft, Gs, Gs, Gs^Ft, Gs^Ft, Gs^Ft, Gs^Ft, Gs^Ft, Ds, Ds, Ds, Ds, Wwt, Wwt, Wwt, Wwt, Wwt, Wwt, Wwt, Wwt, Wwt, Wwt, Wwt, Wwt, Wwt, Wwt, Wot, Wot, Wot, Wot, Wot, Wot, Wot, Wot, Wot, Wot, Wot, Wot, Wot, Wot, Wot, Wot
Wot, Wot, Wot, Wwt, Wwt, Wwt, Wwt, Wwt, Wwt, Wwt, Wwr, Ww, Ww, Ww, Wwt, Wwt, Wwt, Mm, Mm, Mm, Mm, Gll^Ftr, Ww^Ewf, Ww^Ewf, Mm, Gll^Ftr, Gll^Ftr, Ww^Ewf, Ww^Ewl, Gll^Ftr, Gll^Ftr, Gll^Ftr, Mm, Mm, Mm, Gll^Ftr, Gll^Ftr, Gll^Ftr, Gll^Ftr, Wwt, Gs^Ft, Gs^Ft, Gs^Ft, Gs^Ft, Gs, Gs^Ft, Gs^Ft, Gs^Ft, Ds, Ds, Ds, Wwt, Wwt, Wwt, Wwt, Wwt, Wwt, Wwt, Wwt, Wwt, Wwt, Wwt, Wwt, Wwt, Wwt, Wwt, Wot, Wot, Wot, Wot, Wot, Wot, Wot, Wot, Wot, Wot, Wot, Wot, Wot, Wot, Wot, Wot
Wot, Wot, Wot, Wwt, Wwt, Wwt, Wwt, Wwt, Wwt, Wwr, Ww, Ww, Ww, Wwt, Wwt, Wwt, Wwt, Mm, Mm, Mm, Mm, Mm, Mm, Mm, Mm, Mm, Mm, Gll^Ftr, Gll^Ftr, Wwt, Wwt, Gll^Ftr, Mm, Mm, Mm, Gll^Ftr, Gg^Emf, Gll^Ftr, Gs^Ftp, Wwt, Gs^Ft, Gs^Ft, Gs^Ft, Gs^Ft, Gs^Ft, Gs, Dd^Do, Gs^Ft, Dd^Ftd, Ds, Ds, Wwt, Wwt, Wwt, Wwt, Wwt, Wwt, Wwt, Wwt, Wwt, Wwt, Wwt, Wwt, Wwt, Wwt, Wwt, Wot, Wot, Wot, Wot, Wot, Wot, Wot, Wot, Wot, Wot, Wot, Wot, Wot, Wot, Wot, Wot
Wot, Wot, Wwt, Wwt, Wwt, Wwt, Wwt, Wwt, Wwt, Wwr, Ww, Ww, Wwt, Wwt, Wwt, Wwt, Wwt, Mm, Mm, Mm, Mm, Mm, Mm, Mm, Mm, Mm, Mm, Gll^Ftr, Gll^Ftr, Gll^Ftr, Wwt, Gll^Ftr, Gll^Ftr, Mm, Gll^Ftr, Gll^Ftr, Gll^Ftr, Gll^Ftr, Gll^Ftr, Wwt, Wwt, Ss, Ss, Ss, Gs^Ft, Gs^Ft, Gs^Ft, Gs^Ft, Gs, Ds, Ds, Ds, Wwt, Wwt, Wwt, Wwt, Wwt, Wwt, Wwt, Wwt, Wwt, Wwt, Wwt, Wwt, Wwt, Wwt, Wwt, Wot, Wot, Wot, Wot, Wot, Wot, Wot, Wot, Wot, Wot, Wot, Wot, Wot, Wot, Wot
Wot, Wot, Wwt, Wwt, Wwt, Wwt, Wwt, Wwt, Wwt, Wwr, Ww, Ww, Wwt, Wwt, Wwt, Wwt, Wwt, Wwt, Mm, Mm, Gll^Ftr, Gll^Ftr, Mm, Mm, Mm, Mm, Mm, Gll^Ftr, Gll^Ftr, Gll^Ftr, Wwt, Gll^Ftr, Gll^Ftr, Gll^Ftr, Gll^Ftr, Dd^Do, Gg^Em, Gll^Ftr, Gll^Ftr, Gll^Ftr, Ss, Wwt, Ss, Gs^Ft, Gs^Ft, Gs^Ft, Gs^Ft, Gs^Ft, Gs^Ft, Ds, Ds, Ds, Wwt, Wwt, Wwt, Wwt, Wwt, Wwt, Wwt, Wwt, Wwt, Wwt, Wwt, Wwt, Wwt, Wwt, Wwt, Wot, Wot, Wot, Wot, Wot, Wot, Wot, Wot, Wot, Wot, Wot, Wot, Wot, Wot, Wot
Wot, Wwt, Wwt, Wwt, Wwt, Wwt, Ww, Ww, Ww, Ww, Wwt, Wwt, Wwt, Wwt, Mm, Ww, Mm, Mm, Mm, Mm, Wwr, Wwr, Wwrt, Mm, Mm, Mm, Mm, Mm, Mm, Gll^Ftr, Gll^Ftr, Wwt, Wwt, Gll^Ftr, Wwt, Gll^Ftr, Gll^Ftr, Gll^Ftr, Gg, Gll^Ftr, Gg, Wwt, Wwt, Gs^Ft, Ss, Ss, Gs^Ft, Gs^Ft, Ds, Ds, Ds, Ds, Wwt, Wwt, Wwt, Wwt, Wwt, Wwt, Wwt, Wwt, Wwt, Wwt, Wwt, Wwt, Wwt, Wwt, Wot, Wot, Wot, Wot, Wot, Wot, Wot, Wot, Wot, Wot, Wot, Wot, Wot, Wot, Wot, Wot
Wwt, Wwt, Wwt, Wwt, Wwt, Wwt, Wwt, Wwt, Wwt, Wwt, Wwt, Wwt, Wwt, Mm, Mm, Mm, Mm, Mm, Mm, Mm, Mm, Gll^Ftr, Wwt, Gll^Ftr, Gll^Ftr, Mm, Mm, Mm, Mm, Gll^Ftr, Gll^Ftr, Gll^Ftr, Gll^Ftr, Wwt, Gll^Ftr, Wwt, Wwt, Gll^Ftr, Wwt, Ss, Ss, Ss, Ss, Wwt, Ss, Gs^Ft, Gs^Ft, Ds^Es, Ds, Ds, Wwt, Wwt, Wwt, Wwt, Wwt, Wwt, Wwt, Wwt, Wwt, Wwt, Wwt, Wwt, Wwt, Wwt, Wwt, Wwt, Wot, Wot, Wot, Wot, Wot, Wot, Wot, Wot, Wot, Wot, Wot, Wot, Wot, Wot, Wot, Wot
Wwt, Wwt, Wwt, Wwt, Wwt, Wwt, Wwt, Wwt, Wwt, Wwt, Wwt, Wwt, Wwt, Ww, Mm, Mm, Mm, Mm, Mm, Mm, Mm, Gll^Ftr, Gll^Ftr, Wwt, Wwt, Mm, Mm, Mm, Mm, Mm, Gll^Ftr, Gll^Ftr, Gll^Ftr, Gll^Ftr, Gll^Ftr, Gll^Ftr, Gll^Ftr, Wwt, Gll^Ftr, Wwt, Wwt, Ss, Ss, Wwt, Ss, Ss, Gs^Ft, Gs, Ds, Ds, Wwt, Wwt, Wwt, Wwt, Wwt, Wwt, Wwt, Wwt, Wwt, Wwt, Wwt, Wwt, Wwt, Wwt, Wwt, Wwt, Wot, Wot, Wot, Wot, Wot, Wot, Wot, Wot, Wot, Wot, Wot, Wot, Wot, Wot, Wot, Wot
Wwt, Wwt, Wwt, Wwt, Wwt, Wwt, Wwt, Wwt, Wwt, Wwt, Ww, Wwt, Wwt, Mm, Mm, Mm, Mm, Mm, Mm, Mm, Mm, Mm, Mm, Gll^Ftr, Wwt, Gll^Ftr, Gll^Ftr, Mm, Mm, Mm, Gll^Ftr, Gll^Ftr, Gg^Em, Gll^Ftr, Gll^Ftr, Gg, Gll^Ftr, Gll^Ftr, Gll^Ftr, Gll^Ftr, Gll^Ftr, Wwt, Ss, Wwt, Wwt, Ss, Dd^Ftd, Ds, Ds, Ds, Wwt, Wwt, Wwt, Wwt, Wwt, Wwt, Wwt, Wwt, Wwt, Wwt, Wwt, Wwt, Wwt, Wwt, Wwt, Wwt, Wot, Wot, Wot, Wot, Wot, Wot, Wot, Wot, Wot, Wot, Wot, Wot, Wot, Wot, Wot, Wot
Wwt, Wwt, Wwt, Wwt, Wwt, Wwt, Wwt, Wwt, Ww, Ww, Wwt, Wwt, Wwt, Wwt, Mm, Mm, Ww, Wwr, Mm, Mm, Mm, Mm, Mm, Gll^Ftr, Gll^Ftr, Wwt, Wwt, Gll^Ftr, Gll^Ftr, Gll^Ftr, Gll^Ftr, Gg^Em, Gll^Ftr, Gll^Ftr, Gll^Ftr, Gll^Ftr, Gll^Ftr, Gll^Ftr, Gll^Ftr, Gll^Ftr, Gg, Wwt, Ss, Ss, Wwt, Dd^Ftd, Dd^Do, Dd^Ftd, Ds, Ds, Ds, Wwt, Wwt, Wwt, Wwt, Wwt, Wwt, Wwt, Wwt, Wwt, Wwt, Wwt, Wwt, Wwt, Wwt, Wwt, Wot, Wot, Wot, Wot, Wot, Wot, Wot, Wot, Wot, Wot, Wot, Wot, Wot, Wot, Wot, Wot
Wwt, Wwt, Wwt, Wwt, Ww, Ww, Ww, Wwt, Wwt, Wwt, Wwt, Wwt, Ww, Ww, Ww, Mm, Mm, Ww, Mm, Mm, Mm, Mm, Mm, Gll^Ftr, Dd^Do, Gll^Ftr, Wwt, Gll^Ftr, Gll^Ftr, Gll^Ftr, Gll^Ftr, Gll^Ftr, Gll^Ftr, Gg^Em, Gll^Ftr, Gll^Ftr, Gll^Ftr, Gll^Ftr, Gll^Ftr, Gll^Ftr, Gll^Ftr, Wwt, Wwt, Wwt, Gs^Ft, Gs^Ft, Gs^Ft, Dd^Ftd, Dd^Ftd, Ds, Ds, Wwt, Wwt, Wwt, Wwt, Wwt, Wwt, Wwt, Wwt, Wwt, Wwt, Wwt, Wwt, Wwt, Wwt, Wwt, Wwt, Wot, Wot, Wot, Wot, Wot, Wot, Wot, Wot, Wot, Wot, Wot, Wot, Wot, Wot, Wot
Wwt, Wwt, Wwt, Wwt, Wwt, Wwt, Wwt, Ww, Wwt, Wwt, Wwt, Wwt, Mm, Mm, Mm, Mm, Mv, Mm, Mm, Mm, Mm, Mm, Mm, Gll^Ftr, Gll^Ftr, Gll^Ftr, Gll^Ftr, Wwt, Wwt, Gll^Ftr, Gll^Ftr, Gll^Ftr, Gll^Ftr, Gll^Ftr, Gll^Ftr, Dd^Do, Gll^Ftr, Gll^Ftr, Gg, Gll^Ftr, Gll^Ftr, Wwt, Gs^Ft, Gs^Ft, Gs^Ft, Gs^Ft, Gs^Ft, Dd^Ftd, Gs^Ft, Ds, Ds, Ds, Wwt, Wwt, Wwt, Wwt, Wwt, Wwt, Wwt, Wwt, Wwt, Wwt, Wwt, Wwt, Wwt, Wwt, Wwt, Wot, Wot, Wot, Wot, Wot, Wot, Wot, Wot, Wot, Wot, Wot, Wot, Wot, Wot, Wot
Wwt, Wwt, Wwt, Wwt, Wwt, Wwt, Wwt, Wwt, Wwt, Wwt, Wwt, Wwt, Mm, Mm, Ur, Mv, Mv, Ur, Mm, Mm, Mm, Mm, Mm, Mm, Gll^Ftr, Gll^Ftr, Gll^Ftr, Gll^Ftr, Wwt, Gll^Ftr, Gll^Ftr, Gll^Ftr, Gll^Ftr, Gll^Ftr, Gll^Ftr, Gll^Ftr, Gg, Gll^Ftr, Gll^Ftr, Gll^Ftr, Gll^Ftr, Wwt, Gs^Ft, Gs^Ft, Gs^Ft, Gs^Ft, Gs^Ft, Gs^Ft, Gs^Ft, Ds^Esd, Ds, Ds, Wwt, Wwt, Wwt, Wwt, Wwt, Wwt, Wwt, Wwt, Wwt, Wwt, Wwt, Wwt, Wwt, Wwt, Wwt, Wot, Wot, Wot, Wot, Wot, Wot, Wot, Wot, Wot, Wot, Wot, Wot, Wot, Wot, Wot
Wwt, Wwt, Wwt, Wwt, Wwt, Wwt, Wwt, Wwt, Wwt, Wwt, Wwt, Wwt, Mm, Mm, Mm, Mm, Mm, Mm, Mm, Mm, Mm, Mm, Mm, Mm, Mm, Gll^Ftr, Gll^Ftr, Gll^Ftr, Gll^Ftr, Wwt, Wwt, Gg, Gll^Ftr, Gll^Ftr, Gll^Ftr, Gg, Gll^Ftr, Gll^Ftr, Gll^Ftr, Gll^Ftr, Gll^Ftr, Wwt, Wwt, Gs^Ft, Gs^Ft, Gs^Ft, Gs^Ft, Gs^Ft, Dd^Ftd, Gs^Ft, Ds, Ds, Ds, Wwt, Ds, Wwt, Wwt, Wwt, Wwt, Wwt, Wwt, Wwt, Wwt, Wwt, Wwt, Wwt, Wwt, Wwt, Wot, Wot, Wot, Wot, Wot, Wot, Wot, Wot, Wot, Wot, Wot, Wot, Wot, Wot
Wwt, Wwt, Wwt, Wwt, Wwt, Wwt, Ww, Wwt, Wwt, Wwt, Wwt, Wwt, Mm, Mm, Mm, Mm, Mm, Mm, Mm, Mm, Mm, Mm, Mm, Mm, Mm, Gll^Ftr, Gll^Ftr, Gll^Ftr, Gll^Ftr, Gll^Ftr, Gll^Ftr, Wwt, Wwt, Gll^Ftr, Gll^Ftr, Gll^Ftr, Gll^Ftr, Gll^Ftr, Gll^Ftr, Gll^Ftr, Gll^Ftr, Gll^Ftr, Wwt, Gs^Ft, Gs^Ft, Gs^Ft, Dd^Ftd, Ds, Gs^Ft, Ds, Dd^Ftd, Ds, Ds, Ds, Ds, Ds, Ds, Wwt, Wwt, Wwt, Wwt, Wwt, Wwt, Wwt, Wwt, Wwt, Wwt, Wwt, Wot, Wot, Wot, Wot, Wot, Wot, Wot, Wot, Wot, Wot, Wot, Wot, Wot, Wot
Wwt, Wwt, Wwt, Wwt, Wwt, Ww, Ww, Ww, Wwt, Wwt, Wwt, Wwt, Ww, Mm, Mm, Mm, Mm, Mm, Mm, Mm, Gll^Ftr, Gll^Ftr, Gll^Ftr, Mm, Hh^Ftr, Hh^Ftr, Gll^Ftr, Gll^Ftr, Gll^Ftr, Gll^Ftr, Gll^Ftr, Gll^Ftr, Gll^Ftr, Wwt, Wwt, Wwt, Wwt, Gll^Ftr, Wwt, Gll^Ftr, Gll^Ftr, Gg, Wwt, Gs^Ft, Gs^Ft, Gs^Ft, Gs^Ft, Gs^Ft, Gs^Ft, Gs^Ft, Gs^Ft, Gs, Gs^Ft, Ds, Ds, Ds^Esd, Ds, Wwt, Wwt, Wwt, Wwt, Wwt, Wwt, Wwt, Wwt, Wwt, Wwt, Wwt, Wwt, Wot, Wot, Wot, Wot, Wot, Wot, Wot, Wot, Wot, Wot, Wot, Wot, Wot
Wwt, Wwt, Wwt, Wwt, Wwt, Wwr, Ww, Ww, Ww, Wwt, Wwt, Wwt, Wwt, Ww, Mm, Mm, Mm, Mm, Mm, Mm, Gll^Ftr, Gll^Ftr, Wwt, Gll^Ftr, Ww^Ewf, Hh^Ftr, Gll^Ftr, Gg^Emf, Gll^Ftr, Gll^Ftr, Gll^Ftr, Gll^Ftr, Gll^Ftr, Gll^Ftr, Gll^Ftr, Gll^Ftr, Gll^Ftr, Wwt, Gg, Wwt, Wwt, Gll^Ftr, Gll^Ftr, Wwt, Gs^Ft, Gs^Ft, Gs^Ft, Gs^Ft, Gs^Ft, Ds^Do, Gs^Ft, Gs^Ft, Ss, Gs^Ft, Dd^Ftd, Ds, Ds, Wwt, Ds, Wwt, Wwt, Wwt, Wwt, Wwt, Wwt, Wwt, Wwt, Wwt, Wwt, Wot, Wot, Wot, Wot, Wot, Wot, Wot, Wot, Wot, Wot, Wot, Wot, Wot
Wwt, Wwt, Wwt, Wwt, Wwt, Wwr, Ww, Ww, Ww, Wwt, Wwt, Wwt, Ww, Wwt, Wwt, Wwt, Mm, Mm, Mm, Gll^Do, Gll^Ftr, Ww^Ewl, Wot, Wwrt, Wwt, Gll^Ftr, Gll^Ftr, Gll^Ftr, Gs^Ftp, Gll^Ftr, Gs^Ftp, Gll^Ftr, Gs^Do, Gll^Ftr, Gg, Gs^Ft, Gs^Ft, Gll^Ftr, Gs^Ft, Gg, Gs^Ft, Wwt, Wwt, Wwt, Wwt, Gs^Ft, Wwt, Gs^Ft, Gs^Ft, Gs^Ft, Gs^Ft, Gs^Ft, Ss, Ss, Ss, Ds, Ds, Ds, Ss, Ds, Ds, Ds, Wwt, Wwt, Wwt, Wwt, Wwt, Wwt, Wwt, Wot, Wot, Wot, Wot, Wot, Wot, Wot, Wot, Wot, Wot, Wot, Wot, Wot
Wwt, Wwt, Wwt, Wwt, Wwt, Wwr, Ww, Ww, Ww, Wwt, Wwt, Ww, Ww, Wwt, Wwt, Mm, Mm, Mm, Mm, Mm, Gll^Ftr, Wwt, Wot, Wot, Wwt, Wwt, Wwt, Gs^Ftp, Gs^Ftp, Gg, Gs^Ftp, Gs^Ftp, Gs^Ftp, Gs^Ftp, Gs^Ft, Gs^Ft, Gs^Ft, Gs^Ft, Gs^Ft, Gs^Ft, Gs^Ft, Gs^Ft, Gs^Ft, Gll^Ftr, Gs^Ft, Wwt, Gs^Ft, Wwt, Wwt, Gs^Ft, Wwt, Gs^Ft, Ss, Gs^Ft, Gs^Ft, Ss, Ds, Ss, Sm, Ds, Wwt, Wwt, Wwt, Wwt, Wwt, Wwt, Wwt, Wwt, Wwt, Wot, Wot, Wot, Wot, Wot, Wot, Wot, Wot, Wot, Wot, Wot, Wot, Wot
Wwt, Wwt, Wwt, Wwt, Wwt, Ww, Ww, Ww, Wwt, Wwt, Ww, Ww, Ww, Wwt, Wwt, Mm, Mm, Mm, Mm, Mm, Gll^Ftr, Wwt, Wwt, Wwt, Gll^Ftr, Gll^Ftr, Gll^Ftr, Wwt, Gs^Ftp, Gs^Ftp, Gs^Ftp, Gs^Ftp, Gs^Ft, Gs^Ft, Gs^Ft, Gs^Ft, Gs^Ft, Gs^Ft, Gs^Ft, Gs^Ft, Gs^Ft, Gs^Ft, Gs^Ft, Gs^Ft, Gs^Ft, Gs^Ft, Gs^Ft, Gs^Ft, Gs^Ft, Wwt, Dd^Ftd, Wwt, Wwt, Ss, Ss, Ss, Ss, Ss, Sm, Wwt, Wwt, Wwt, Wwt, Wwt, Wwt, Wwt, Wwt, Wwt, Wwt, Wot, Wot, Wot, Wot, Wot, Wot, Wot, Wot, Wot, Wot, Wot, Wot, Wot
Wwt, Wwt, Wwt, Wwt, Wwt, Ww, Ww, Ww, Ww, Ww, Ww, Ww, Ww, Wwt, Mm, Mm, Mm, Mm, Mm, Mm, Gll^Ftr, Gll^Ftr, Gll^Ftr, Gll^Ftr, Gll^Ftr, Gll^Ftr, Gs^Ftp, Wwt, Wwt, Gs^Ftp, Gs^Ft, Gg, Gs^Ft, Gs^Ft, Gs^Ft, Gs^Ft, Gs^Ft, Gs^Ft, Dd^Ftd, Gs^Ft, Gs^Ft, Gs^Ft, Gs^Ft, Gs^Ft, Gs^Ft, Gs^Ft, Gs^Ft, Gs^Ft, Ss, Ss, Ss, Dd^Ftd, Gs^Ft, Wwt, Wwt, Wwt, Wwt, Ss, Sm, Sm, Sm, Sm, Wwt, Wwt, Wwt, Wwt, Wwt, Wwt, Wwt, Wot, Wot, Wot, Wot, Wot, Wot, Wot, Wot, Wot, Wot, Wot, Wot, Wot
Wwt, Wwt, Wwt, Wwt, Wwt, Wwr, Ww, Ww, Ww, Ww, Ww, Ww, Wwt, Wwt, Mm, Mm, Mm, Mm, Mm, Mm, Mm, Gll^Ftr, Gll^Ftr, Gll^Ftr, Gll^Ftr, Gg, Gg, Gg, Gs^Ftp, Wwt, Wwt, Gg, Gs^Ft, Gs^Ft, Gs^Ft, Gs^Ft, Dd^Ftd, Dd^Do, Gs^Ft, Dd^Ftd, Dd^Ftd, Gs^Ft, Gs^Ft, Gs^Ft, Gs^Ft, Gs^Ft, Gs^Ft, Gs^Ft, Gs^Ft, Gs^Ft, Ss, Ss, Ss, Gs^Ft, Ss, Wwrt, Ss, Wwt, Wwt, Wwt, Wwt, Wwt, Wwt, Wwt, Wwt, Wwt, Wwt, Wwt, Wwt, Wwt, Wot, Wot, Wot, Wot, Wot, Wot, Wot, Wot, Wot, Wot, Wot, Wot
Wwt, Wwt, Wwt, Wwt, Wwt, Ww, Wwr, Ww, Ww, Ww, Ww, Wwt, Wwt, Wwt, Mm, Mm, Mm, Mm, Mm, Mm, Mm, Mm, Mm, Gll^Ftr, Gs^Ftp, Gg, Gs^Ftp, Gg, Gs^Ftp, Gg, Gs^Ftp, Wwt, Wwt, Gs^Ft, Gg, Gs^Ft, Gs^Ft, Dd^Ftd, Gs^Ft, Gs^Ft, Ds, Gs^Ft, Gg, Gs^Ft, Gg, Gs^Ft, Gs^Ft, Gs^Ft, Gs^Ft, Gs^Ft, Gs^Ft, Gs^Ft, Gs^Ft, Ss, Ss, Ss, Ss, Sm, Sm, Wwt, Wwt, Wwt, Wwt, Wwt, Wwt, Wwt, Wwt, Wwt, Wwt, Wwt, Wwt, Wot, Wot, Wot, Wot, Wot, Wot, Wot, Wot, Wot, Wot, Wot
Wwt, Wwt, Wwt, Wwt, Wwt, Wwt, Wwt, Wwr, Ww, Ww, Wwt, Wwt, Ww, Wwt, Wwt, Mm, Mm, Mm, Mm, Mm, Mm, Mm, Mm, Gll^Ftr, Gs^Ftp, Gs^Ftp, Gs^Ftp, Ds, Dd^Do, Gs^Ftp, Gs^Ftp, Gs^Ft, Gs^Ft, Wwt, Gg, Gs^Ft, Gs^Ft, Gs^Ft, Gs^Ft, Gs^Ft, Dd^Ftd, Gs^Ft, Gs^Ft, Gg, Gg, Gs^Ft, Gs^Ft, Gs^Ft, Dd^Ftd, Gs^Ft, Gs^Ft, Gs^Ft, Gs^Ft, Gs^Ft, Ds, Ss, Ds, Ds, Sm, Wwt, Wwt, Wwt, Wwt, Wwt, Wwt, Wwt, Wwt, Wwt, Wwt, Wwt, Wot, Wot, Wot, Wot, Wot, Wot, Wot, Wot, Wot, Wot, Wot, Wot
Wwt, Wwt, Wwt, Ww, Ww, Ww, Ww, Wwt, Wwt, Wwt, Ww, Ww, Wwt, Wwt, Wwt, Mm, Mm, Mm, Mm, Mm, Mm, Mm, Mm, Gs^Ftp, Mm, Gs^Ftp, Gs^Ftp, Gs^Ftp, Gs^Ftp, Gg, Gs^Ftp, Gs^Ftp, Gs^Ftp, Wwt, Wwt, Gs^Ft, Gs^Ft, Gs^Ft, Gs^Ft, Gs^Ft, Gs^Ft, Dd^Ftd, Dd^Ftd, Gs^Ft, Gs^Ft, Gs^Ft, Dd^Ftd, Dd^Do, Ds, Dd^Ftd, Ds, Dd^Ftd, Dd^Ftd, Ds, Ds, Ds, Wwt, Wwt, Wwt, Wwt, Wwt, Wwt, Wwt, Wwt, Wwt, Wwt, Wwt, Wwt, Wwt, Wwt, Wwt, Wot, Wot, Wot, Wot, Wot, Wot, Wot, Wot, Wot, Wot, Wot
Wwt, Wwt, Wwt, Wwt, Ww, Wwt, Wwt, Wwt, Wwt, Wwt, Wwt, Wwt, Ww, Wwt, Mm, Mm, Mm, Mm, Mm, Mm, Mm, Mm, Mm, Mm, Mm, Mm, Gs^Ftp, Gs^Ftp, Gs^Ftp, Gs^Ftp, Gs^Ftp, Gs^Ftp, Gs^Ftp, Gg, Wwt, Wwt, Wwt, Gs^Ft, Gs^Ft, Gs^Ft, Gs, Dd^Ftd, Gs^Ftp, Ds, Dd^Ftd, Dd^Ftd, Dd^Ftd, Dd^Ftd, Gs^Ftp, Dd^Ftd, Dd^Ftd, Dd^Ftd, Dd^Ftd, Ds, Ds, Ds, Wwt, Wwt, Wwt, Wwt, Wwt, Wwt, Wwt, Wwt, Wwt, Wwt, Wwt, Wwt, Wwt, Wwt, Wot, Wot, Wot, Wot, Wot, Wot, Wot, Wot, Wot, Wot, Wot, Wot
Wwt, Wwt, Wwt, Ww, Wwt, Wwt, Wwt, Ww, Ww, Wwt, Wwt, Ww, Ur, Wwr, Mm, Mm, Mm, Mm, Mm, Mm, Mm, Mm, Mm, Mm, Mm, Mm, Hh^Ftp, Gs^Ftp, Gs^Ftp, Gg, Gs^Ftp, Gs^Ftp, Gs^Ftp, Gs^Ftp, Wwt, Gs^Ft, Wwt, Gg, Gs^Ft, Gs^Ft, Gs^Ft, Gs, Gs^Ftp, Gs^Ftp, Gs^Ftp, Gs^Ftp, Gs^Ftp, Gs^Ftp, Gs^Ftp, Ds, Gs^Ftp, Gs, Gs, Ds, Ds, Ds, Wwt, Wwt, Wwt, Wwt, Wwt, Wwt, Wwt, Wwt, Wwt, Wwt, Wwt, Wwt, Wwt, Wwt, Wot, Wot, Wot, Wot, Wot, Wot, Wot, Wot, Wot, Wot, Wot, Wot
Wwt, Wwt, Wwt, Wwt, Wwr, Wwr, Ww, Wwt, Wwt, Wwt, Ww, Ur, Ur, Ur, Mv, Mm, Mm, Mm, Mm, Mm, Mm, Mm, Hh^Ftp, Mm, Gs^Ftp, Hh^Ftp, Gg, Gs^Ftp, Gs^Ftp, Gs, Ds, Gs, Ds, Gs^Ftp, Wwt, Gs^Ft, Gs^Ft, Wwt, Wwt, Gs^Ft, Gs^Ft, Gs^Ftp, Gs^Ftp, Gs^Ftp, Gs^Ftp, Gs^Ftp, Gs^Ftp, Gs^Ftp, Gs^Ftp, Gs^Ftp, Gs^Ftp, Dd^Ftd, Ds, Ds, Ds, Wwt, Wwt, Wwt, Wwt, Wwt, Wwt, Wwt, Wwt, Wwt, Wwt, Wwt, Wwt, Wwt, Wot, Wot, Wot, Wot, Wot, Wot, Wot, Wot, Wot, Wot, Wot, Wot, Wot, Wot
Wwt, Wwt, Wwt, Wwt, Ww, Ww, Ww, Wwt, Wwt, Wwt, Wwt, Ww, Ur, Mm, Mm, Mm, Mv, Mm, Mm, Mm, Mm, Mm, Gs^Ftp, Hh^Ftd, Gs^Ftp, Gs^Ftp, Gs^Ftp, Gs, Gs^Ftp, Ds^Ftd, Ds, Ds^Ftd, Gs^Ftp, Gs^Vd, Gs^Ft, Wwt, Wwt, Ww^Ewl, Wwt, Gg, Gs^Ft, Gs^Ft, Ds, Gs^Ftp, Gs^Ftp, Gs^Ftp, Gs^Ftp, Gs^Ftp, Gs^Ftp, Gs^Ftp, Gs, Ds, Ds, Ds, Wwt, Wwt, Wwt, Wwt, Wwt, Wwt, Wwt, Wwt, Wwt, Wwt, Wwt, Wwt, Wwt, Wwt, Wot, Wot, Wot, Wot, Wot, Wot, Wot, Wot, Wot, Wot, Wot, Wot, Wot, Wot
Wwt, Wwt, Wwt, Wwt, Wwr, Ww, Ww, Ww, Wwt, Wwt, Ww, Ur, Wwr, Ur, Ur, Mm, Mm, Mm, Mm, Mm, Dd^Ftd, Gs^Ftp, Gs^Ftp, Gs^Ftp, Gs^Ftp, Gs^Ftp, Ds, Dd^Ftd, Ds^Do, Ds, Gs, Dd^Ftd, Gs^Ftp, Gs^Ftp, Gs^Ftp, Gs^Ftp, Gs^Ftp, Wwt, Gs^Ftp, Wwt, Wwt, Gs^Ft, Gg, Dd^Do, Gs^Ftp, Gs^Ftp, Ss, Gs^Ftp, Ss^Ftp, Ds, Ds, Ds, Ds, Ds, Wwt, Wwt, Wwt, Wwt, Wwt, Wwt, Wwt, Wwt, Wwt, Wwt, Wwt, Wwt, Wwt, Wwt, Wot, Wot, Wot, Wot, Wot, Wot, Wot, Wot, Wot, Wot, Wot, Wot, Wot, Wot
Wwt, Wwt, Wwt, Wwt, Wwt, Wwr, Ww, Ww, Wwt, Wwt, Wwt, Ww, Wwt, Ww, Ww, Wwr, Ur, Mm, Mm, Mm, Mm, Gs^Ftp, Mm, Mm, Mm, Dd^Ftd, Mm, Mm, Mm, Gs^Ftp, Gs^Ftp, Gs^Ftp, Dd^Ftd, Gs^Ftp, Gs^Ftp, Gs^Ftp, Gs^Ftp, Gs^Ftp, Gs^Ftp, Gs^Ftp, Gs^Ftp, Wwt, Wwt, Gs^Ftp, Gs^Ftp, Gs^Ftp, Ss, Ss, Ss, Ds, Ds, Ds, Ds, Wwt, Wwt, Wwt, Wwt, Wwt, Wwt, Wwt, Wwt, Wwt, Wwt, Wwt, Wwt, Wwt, Wwt, Wwt, Wot, Wot, Wot, Wot, Wot, Wot, Wot, Wot, Wot, Wot, Wot, Wot, Wot, Wot
Wwt, Wwt, Wwt, Wwt, Wwt, Wwr, Ww, Ww, Ww, Wwt, Wwt, Wwt, Wwt, Wwt, Wwr, Ww, Ur, Ur, Mv, Mm, Mm, Mm, Mm, Mm, Mm, Mm, Mm, Mm, Mm, Ds, Ds, Gs^Ftp, Gs, Gs, Gs^Ftp, Gs^Ftp, Gs^Ftp, Gs^Ftp, Gs^Ftp, Gs^Ftp, Gs^Ftp, Gs^Ftp, Gs^Ftp, Wwt, Wwt, Sm, Ss, Ww^Ewl, Ss, Ss, Ds, Ds, Wwt, Wwt, Wwt, Wwt, Wwt, Wwt, Wwt, Wwt, Wwt, Wwt, Wwt, Wwt, Wwt, Wwt, Wwt, Wot, Wot, Wot, Wot, Wot, Wot, Wot, Wot, Wot, Wot, Wot, Wot, Wot, Wot, Wot
Wwt, Wwt, Wwt, Wwt, Wwt, Ww, Wwr, Ww, Ww, Wwt, Wwt, Wwt, Ww, Wwt, Ww, Ur, Ur, Mm, Mm, Mm, Mv, Mm, Mm, Mm, Mm, Mm, Mm, Mm, Mm, Dd^Ftd, Dd^Ftd, Gs^Ftp, Gs^Ftp, Gs^Ftp, Gs^Ftp, Gs^Ftp, Gs^Ftp, Gs^Ftp, Ss, Gs^Ftp, Ss, Gs^Ftp, Ss, Gs^Ftp, Wwt, Sm, Ds, Ss, Ds, Ds, Ds, Ds, Dd^Ftd, Wwt, Wwt, Wwt, Wwt, Wwt, Wwt, Wwt, Wwt, Wwt, Wwt, Wwt, Wwt, Wwt, Wwt, Wot, Wot, Wot, Wot, Wot, Wot, Wot, Wot, Wot, Wot, Wot, Wot, Wot, Wot, Wot
Wwt, Wwt, Wwt, Wwt, Wwt, Wwt, Wwr, Ww, Ww, Wwt, Wwt, Wwt, Ww, Ww, Ww, Ur, Mm, Mv, Mm, Mv, Mm, Mm, Mm, Wwr, Wwr, Mm, Mm, Mm, Dd^Ftd, Dd^Ftd, Gs^Ftp, Gs^Ftp, Gs^Ftp, Gs^Ftp, Gs^Ftp, Dd^Do, Gs^Ftp, Gs^Ftp, Gs^Ftp, Ss, Ww^Ewl, Ss, Ss, Sm, Wwt, Sm, Ds, Ds, Wwt, Ds, Wwt, Wwt, Wwt, Wwt, Wwt, Wwt, Wwt, Wwt, Wwt, Wwt, Wwt, Wwt, Wwt, Wwt, Wwt, Wwt, Wot, Wot, Wot, Wot, Wot, Wot, Wot, Wot, Wot, Wot, Wot, Wot, Wot, Wot, Wot, Wot
Wwt, Wwt, Wwt, Wwt, Wwt, Wwt, Wwr, Ww, Ww, Wwt, Wwt, Ww, Ww, Ww, Ww, Wwt, Mm, Mm, Mm, Mm, Mm, Mm, Mm, Mm, Wwr, Wwr, Wwr, Wwr, Dd^Ftd, Gs^Ftp, Gg, Gs^Ftp, Gs^Ftp, Gs^Ftp, Gs^Ftp, Gs^Ftp, Gs^Ftp, Gs^Ftp, Ss, Ss, Ss, Ww^Ewf, Ss, Sm, Wwt, Ds, Wwt, Wwt, Wwt, Wwt, Wwt, Wwt, Wwt, Wwt, Wwt, Wwt, Wwt, Wwt, Wwt, Wwt, Wwt, Wwt, Wwt, Wwt, Wwt, Wot, Wot, Wot, Wot, Wot, Wot, Wot, Wot, Wot, Wot, Wot, Wot, Wot, Wot, Wot, Wot, Wot
Wwt, Wwt, Wwt, Wwt, Wwt, Wwt, Wwt, Ww, Wwt, Wwt, Wwt, Wwt, Wwt, Wwt, Wwt, Wwt, Mm, Mm, Mm, Mm, Mm, Mm, Mm, Wwr, Wwr, Ww, Ww, Ww, Wwt, Dd^Ftd, Gs^Ftp, Gs^Ftp, Gs^Ftp, Gs^Ftp, Ds, Gs^Ftp, Gs^Ftp, Ss^Ftp, Ss, Ww^Ewf, Ds, Ss, Ds, Ds, Wwt, Wwt, Wwt, Wwt, Wwt, Wwt, Wwt, Wwt, Wwt, Wwt, Wwt, Wwt, Wwt, Wwt, Wwt, Wwt, Wwt, Wwt, Wwt, Wwt, Wot, Wot, Wot, Wot, Wot, Wot, Wot, Wot, Wot, Wot, Wot, Wot, Wot, Wot, Wot, Wot, Wot, Wot
Wwt, Wwt, Wwt, Wwt, Wwt, Wwt, Wwt, Wwt, Wwt, Wwt, Ww, Wwt, Wwt, Wwt, Wwt, Wwt, Wwt, Mm, Mm, Mm, Mm, Mm, Mm, Wwr, Wwr, Wwr, Ww, Wwt, Dd^Ftd, Dd^Ftd, Ds, Gs^Ftp, Gs^Ftp, Dd^Ftd, Ds, Ds, Ds, Ds, Ds, Ds, Ds, Ds, Ds, Ds, Wwt, Wwt, Wwt, Wwt, Wwt, Wwt, Wwt, Wwt, Wwt, Wwt, Wwt, Wwt, Wwt, Wwt, Wwt, Wwt, Wwt, Wwt, Wwt, Wwt, Wot, Wot, Wot, Wot, Wot, Wot, Wot, Wot, Wot, Wot, Wot, Wot, Wot, Wot, Wot, Wot, Wot, Wot
Wwt, Wwt, Wwt, Wwt, Wwt, Wwt, Wwt, Wwt, Wwt, Ww, Wwt, Wwt, Wwt, Ww, Ww, Wwt, Wwt, Wwt, Mm, Mm, Mm, Mm, Mm, Ww, Ww, Wwr, Wwr, Wwt, Dd^Ftd, Ds, Dd^Ftd, Dd^Ftd, Ds, Ds, Ds, Ds, Ds, Dd^Ftd, Ds, Ds, Wwt, Ds, Wwt, Wwt, Wwt, Wwt, Wwt, Wwt, Wwt, Wwt, Wwt, Wwt, Wwt, Wwt, Wwt, Wwt, Wwt, Wwt, Wwt, Wwt, Wwt, Wwt, Wwt, Wwt, Wot, Wot, Wot, Wot, Wot, Wot, Wot, Wot, Wot, Wot, Wot, Wot, Wot, Wot, Wot, Wot, Wot, Wot
Wwt, Wwt, Wwt, Wwt, Wwt, Wwt, Wwt, Wwt, Ww, Wwt, Wwt, Ww, Wwt, Wwt, Ww, Ww, Wwt, Wwt, Wwt, Mm, Mm, Mm, Mm, Mm, Mm, Wwr, Ww, Wwt, Dd^Ftd, Dd^Ftd, Wwt, Dd^Ftd, Ds, Wwt, Wwt, Wwt, Wwt, Ds, Wwt, Wwt, Wwt, Wwt, Wwt, Wwt, Wwt, Wwt, Wwt, Wwt, Wwt, Wwt, Wwt, Wwt, Wwt, Wwt, Wwt, Wwt, Wwt, Wwt, Wwt, Wwt, Wwt, Wwt, Wwt, Wot, Wot, Wot, Wot, Wot, Wot, Wot, Wot, Wot, Wot, Wot, Wot, Wot, Wot, Wot, Wot, Wot, Wot, Wot
Wot, Wwt, Wwt, Wwt, Wwt, Wwt, Wwt, Wwr, Ww, Ww, Ww, Wwt, Wwt, Wwt, Wwt, Wwt, Ww, Wwt, Wwt, Wwt, Mm, Mm, Mm, Mm, Mm, Wwr, Wwr, Wwt, Wwt, Dd^Ftd, Dd^Ftd, Wwt, Wwt, Wwt, Wwt, Wwt, Wwt, Wwt, Wwt, Wwt, Wwt, Wwt, Wwt, Wwt, Wwt, Wwt, Wwt, Wwt, Wwt, Wwt, Wwt, Wwt, Wwt, Wwt, Wwt, Wwt, Wwt, Wwt, Wwt, Wwt, Wwt, Wwt, Wwt, Wot, Wot, Wot, Wot, Wot, Wot, Wot, Wot, Wot, Wot, Wot, Wot, Wot, Wot, Wot, Wot, Wot, Wot, Wot
Wot, Wot, Wwt, Wwt, Wwt, Wwt, Wwt, Wwr, Wwr, Ww, Ww, Ww, Ww, Wwt, Wwt, Wwt, Wwt, Ww, Wwt, Wwt, Wwt, Mm, Mm, Mm, Mm, Mm, Mm, Ww, Ww, Wwt, Wwt, Wwt, Wwt, Wwt, Wwt, Wwt, Wwt, Wwt, Wwt, Wwt, Wwt, Wwt, Wwt, Wwt, Wwt, Wwt, Wwt, Wwt, Wwt, Wwt, Wwt, Wwt, Wwt, Wwt, Wwt, Wwt, Wwt, Wwt, Wwt, Wwt, Wwt, Wwt, Wot, Wot, Wot, Wot, Wot, Wot, Wot, Wot, Wot, Wot, Wot, Wot, Wot, Wot, Wot, Wot, Wot, Wot, Wot, Wot
Wot, Wot, Wot, Wwt, Wwt, Wwt, Wwt, Wwt, Ww, Ww, Ww, Ww, Ww, Ww, Wwt, Wwt, Wwt, Ww, Wwt, Wwt, Wwt, Wwt, Wwt, Mm, Mm, Mm, Mm, Ww, Ww, Wwt, Ww, Wwt, Wwt, Wwt, Wwt, Wwt, Wwt, Wwt, Wwt, Wwt, Wwt, Wwt, Wwt, Wwt, Wwt, Wwt, Wwt, Wwt, Wwt, Wwt, Wwt, Wwt, Wwt, Wwt, Wwt, Wwt, Wwt, Wwt, Wwt, Wwt, Wot, Wot, Wot, Wot, Wot, Wot, Wot, Wot, Wot, Wot, Wot, Wot, Wot, Wot, Wot, Wot, Wot, Wot, Wot, Wot, Wot, Wot
Wot, Wot, Wot, Wwt, Wwt, Wwt, Wwt, Wwt, Wwt, Wwr, Wwr, Ww, Ww, Ww, Ww, Ww, Ww, Wwt, Wwt, Wwt, Wwt, Wwt, Wwt, Wwt, Wwt, Mm, Mm, Ww, Wwt, Wwt, Wwt, Ww, Wwt, Wwt, Wwt, Wwt, Wwt, Wwt, Wwt, Wwt, Wwt, Wwt, Wwt, Wwt, Wwt, Wwt, Wwt, Wwt, Wwt, Wwt, Wwt, Wwt, Wwt, Wwt, Wwt, Wwt, Wwt, Wwt, Wot, Wot, Wot, Wot, Wot, Wot, Wot, Wot, Wot, Wot, Wot, Wot, Wot, Wot, Wot, Wot, Wot, Wot, Wot, Wot, Wot, Wot, Wot, Wot
Wot, Wot, Wot, Wwt, Wwt, Wwt, Wwt, Wwt, Wwt, Wwt, Wwt, Ww, Wwr, Ww, Ww, Ww, Ww, Ww, Wwt, Wwt, Wwt, Wwt, Wwt, Wwt, Wwt, Wwt, Wwt, Ww, Ww, Wwt, Ww, Wwt, Wwt, Wwt, Wwt, Wwt, Wwt, Wwt, Wwt, Wwt, Wwt, Wwt, Wwt, Wwt, Wwt, Wwt, Wwt, Wwt, Wwt, Wwt, Wwt, Wwt, Wwt, Wwt, Wwt, Wwt, Wwt, Wot, Wot, Wot, Wot, Wot, Wot, Wot, Wot, Wot, Wot, Wot, Wot, Wot, Wot, Wot, Wot, Wot, Wot, Wot, Wot, Wot, Wot, Wot, Wot, Wot
Wot, Wot, Wot, Wwt, Wwt, Wwt, Wwt, Wwt, Wwt, Wwt, Wwt, Wwt, Wwt, Wwr, Wwr, Ww, Ww, Ww, Wwt, Wwt, Wwt, Wwt, Wwt, Wwt, Wwt, Wwt, Wwt, Wwt, Wwt, Ww, Wwt, Wwt, Wwt, Wwt, Wwt, Wwt, Wwt, Wwt, Wwt, Wwt, Wwt, Wwt, Wwt, Wwt, Wwt, Wwt, Wwt, Wwt, Wwt, Wwt, Wwt, Wwt, Wwt, Wwt, Wwt, Wwt, Wot, Wot, Wot, Wot, Wot, Wot, Wot, Wot, Wot, Wot, Wot, Wot, Wot, Wot, Wot, Wot, Wot, Wot, Wot, Wot, Wot, Wot, Wot, Wot, Wot, Wot
Wot, Wot, Wot, Wot, Wot, Wwt, Wwt, Wwt, Wwt, Wwt, Wwt, Wwt, Wwt, Wwt, Wwt, Wwt, Wwt, Wwt, Wwt, Wwt, Wwt, Wwt, Wwt, Wwt, Wwt, Wwt, Wwt, Wwt, Wwt, Wwt, Wwt, Wwt, Wwt, Wwt, Wwt, Wwt, Wwt, Wwt, Wwt, Wwt, Wwt, Wwt, Wwt, Wwt, Wwt, Wwt, Wwt, Wwt, Wwt, Wwt, Wwt, Wwt, Wot, Wot, Wot, Wot, Wot, Wot, Wot, Wot, Wot, Wot, Wot, Wot, Wot, Wot, Wot, Wot, Wot, Wot, Wot, Wot, Wot, Wot, Wot, Wot, Wot, Wot, Wot, Wot, Wot, Wot
Wot, Wot, Wot, Wot, Wot, Wwt, Wwt, Wwt, Wwt, Wwt, Wwt, Wwt, Wwt, Wwt, Wwt, Wwt, Wwt, Wwt, Wwt, Wwt, Wwt, Wwt, Wwt, Wwt, Wwt, Wwt, Wwt, Wwt, Wwt, Wwt, Wwt, Wwt, Wwt, Wwt, Wwt, Wwt, Wwt, Wwt, Wwt, Wwt, Wwt, Wwt, Wwt, Wwt, Wwt, Wwt, Wot, Wwt, Wot, Wwt, Wot, Wot, Wot, Wot, Wot, Wot, Wot, Wot, Wot, Wot, Wot, Wot, Wot, Wot, Wot, Wot, Wot, Wot, Wot, Wot, Wot, Wot, Wot, Wot, Wot, Wot, Wot, Wot, Wot, Wot, Wot, Wot
Wot, Wot, Wot, Wot, 1 Wot, Wot, Wot, Wwt, Wwt, Wwt, Wwt, Wwt, Wwt, Wwt, Wwt, Wwt, Wwt, Wwt, Wwt, Wwt, Wwt, Wwt, Wwt, Wwt, Wwt, Wwt, Wwt, Wwt, Wwt, Wwt, Wwt, Wwt, Wot, Wwt, Wwt, Wwt, Wwt, Wwt, Wwt, Wwt, Wwt, Wwt, Wot, Wwt, Wot, Wot, Wot, Wot, Wot, Wot, Wot, Wot, Wot, Wot, Wot, Wot, Wot, Wot, Wot, Wot, Wot, Wot, Wot, Wot, Wot, Wot, Wot, Wot, Wot, Wot, Wot, Wot, Wot, Wot, Wot, Wot, Wot, Wot, Wot, Wot, Wot, Wot
Wot, Wot, Wot, Wot, Wot, Wot, Wot, Wot, Wot, Wot, Wot, Wwt, Wwt, Wwt, Wwt, Wwt, Wwt, Wwt, Wwt, Wwt, Wot, Wwt, Wot, Wwt, Wwt, Wwt, Wot, Wwt, Wot, Wwt, Wot, Wot, Wot, Wot, Wot, Wwt, Wwt, Wwt, Wot, Wwt, Wot, Wot, Wot, Wot, Wot, Wot, Wot, Wot, Wot, Wot, Wot, Wot, Wot, Wot, Wot, Wot, Wot, Wot, Wot, Wot, Wot, Wot, Wot, Wot, Wot, Wot, Wot, Wot, Wot, Wot, Wot, Wot, Wot, Wot, Wot, Wot, Wot, Wot, Wot, Wot, Wot, Wot
Wot, Wot, Wot, Wot, Wot, Wot, Wot, Wot, Wot, Wot, Wot, Wot, Wot, Wot, Wot, Wwt, Wot, Wwt, Wot, Wot, Wot, Wot, Wot, Wot, Wot, Wot, Wot, Wot, Wot, Wot, Wot, Wot, Wot, Wot, Wot, Wot, Wot, Wot, Wot, Wot, Wot, Wot, Wot, Wot, Wot, Wot, Wot, Wot, Wot, Wot, Wot, Wot, Wot, Wot, Wot, Wot, Wot, Wot, Wot, Wot, Wot, Wot, Wot, Wot, Wot, Wot, Wot, Wot, Wot, Wot, Wot, Wot, Wot, Wot, Wot, Wot, Wot, Wot, Wot, Wot, Wot, Wot
Wot, Wot, Wot, Wot, Wot, Wot, Wot, Wot, Wot, Wot, Wot, Wot, Wot, Wot, Wot, Wot, Wot, Wot, Wot, Wot, Wot, Wot, Wot, Wot, Wot, Wot, Wot, Wot, Wot, Wot, Wot, Wot, Wot, Wot, Wot, Wot, Wot, Wot, Wot, Wot, Wot, Wot, Wot, Wot, Wot, Wot, Wot, Wot, Wot, Wot, Wot, Wot, Wot, Wot, Wot, Wot, Wot, Wot, Wot, Wot, Wot, Wot, Wot, Wot, Wot, Wot, Wot, Wot, Wot, Wot, Wot, Wot, Wot, Wot, Wot, Wot, Wot, Wot, Wot, Wot, Wot, Wot
Wot, Wot, Wot, Wot, Wot, Wot, Wot, Wot, Wot, Wot, Wot, Wot, Wot, Wot, Wot, Wot, Wot, Wot, Wot, Wot, Wot, Wot, Wot, Wot, Wot, Wot, Wot, Wot, Wot, Wot, Wot, Wot, Wot, Wot, Wot, Wot, Wot, Wot, Wot, Wot, Wot, Wot, Wot, Wot, Wot, Wot, Wot, Wot, Wot, Wot, Wot, Wot, Wot, Wot, Wot, Wot, Wot, Wot, Wot, Wot, Wot, Wot, Wot, Wot, Wot, Wot, Wot, Wot, Wot, Wot, Wot, Wot, Wot, Wot, Wot, Wot, Wot, Wot, Wot, Wot, Wot, Wot
