Mm, Mm, Mm, Mm, Mm, Mm, Mm, Mm, Mm, Mm, Mm, Ur, Mm, Mm, Mm, Mm, Mm, Mm, Mm, Mm, Mm, Mm, Mm
Mm, Mm, Mm, Mm, Mm, Mm, Mm, Mm, Hh^Vd, Hh, Hh, P1_Burner Ur, Ur, Hh, Hh, Mm, Mm, Mm, Mm, Mm, Mm, Mm, Mm
Mm, Mm, Mm, Mm, Mm, Mm, Wwt, Wwt, Wwt, Hh, Hh, Hh, Ur, Hh, Hh, Hh, Hh^Vd, Mm, Mm, Mm, Mm, Mm, Mm
Mm, Mm, Mm, Mm, Wwt, Wwt, Ds^Ftp, Ds^Ftp, Ds, Wwt, Wwt, Ur, Wwt, Hh, Wwt, Hh, Wwt, Hh, Wwt, Mm, Mm, Mm, Mm
Mm, Xu, Wwt, Wwt, Ds, Ds, Gs, Gs, Gs, Ds^Es, Ds, Wwt^Bsb|, Ds, Wwt, Ds, Wwt, Ds^Ftp, Wwt, Ds^Es, Wwt, Wwt, Xu, Mm
Mm, Xu, Wwt, Ds^Es, Gs, Gs, Gll^Uf, Gg, Gs, P1_Fighter Ds, Cte, 1 Cud^Kov, Cte, P1_Clasher Ds, Gs, Ds, Gs, Ds^Ftp, Gs, Ds, Wwt, Xu, Mm
Mm, Ww, Xu, Ds, Gs, Gg, Ss, Gg, Gs, Ds, Wwt, P1_Glider Wwt, Wwt^Ewl, Ds, Gs, Qxu, Qxu, Gs, Gs, Ds, Xu, Ww, Mm
Mm, Ww, Xu, Gs, Ss, Ss, Gs, Gs, Ds^Ftp, Ds^Ftp, Wwt, Wwt, Ds, Ds, Gs, Gs, Gll^Uf, Qxu, Gs, Gs, Xu, Ww, Mm
Mm, Ww, Xu, Gg, Ss, Gg^Vd, Gs, Ds, Wwt, Wwt, Ds^Ftp, Ds^Ftp, Gs, Gs, Ss, Gg, Gg, Gs, Gs, Uu, Ww, Ww, Mm
Mm, Ww, Xu, Gg, Gll^Uf, Gg, Gs, Ds, Wwt, Ds, Gs, Gs, Gg, Ss, Ss, Gg^Vd, Gs, Gs, Gs, Uu, Ww, Ww, Mm
Mm, Ww, Xu, Gs, Gs, Gs, Gs, Ds, Wwrt, Ds, Ds, Gs, Gs, Ss, Gll^Uf, Gg, Gs^Ft, Gs^Ft, Gs, Uu, Ww, Ww, Mm
Mm, Ww, Ww, Uu, Gs, Qxu, Gs, Ds, Ds, Wwt, Wwt, Ds^Ftp, Ds^Ftp, Gs, Gs, Gg, Gs^Ft, Gs^Ft, Gs, Uu, Xu, Ww, Mm
Mm, Ww, Ww, Uu, Gs, Qxu, Qxu, Gs, Gs, Ds, Ds^Ftp, Wwt, Wwt, Ds, Ds, Gs, Gs, Gs^Em, Hh, Gs, Xu, Ww, Mm
Mm, Ww, Xu, Uu, Gs, Gs^Em, Gs, Gs, Gs, Gs, Gs, Ds^Ftp, Ds, Wwt, Wwrt, Ds, Gs, Qxu, Hh, Gs, Xu, Ww, Mm
Mm, Ww, Xu, Gs, Hh, Hh, Gs, Gs^Vd, Gg^Em, Gg, Gll^Uf, Gs, Gs, Ds, Wwt, Ds, Gs, Qxu, Gs^Vd, Gs, Xu, Ww, Mm
Mm, Ww, Xu, Gs, Gs, Hh, Gg, Gg, Ss, Ss, Gg, Gs, Ds^Ftp, Ds, Wwt, Ds, Gs, Qxu, Gs, Gs, Xu, Ww, Mm
Mm, Ww, Xu, Gs, Gs, Hh, Gg, Gll^Uf, Ss, Ss, Gs, Ds^Ftp, Wwt, Wwt, Ds^Ftp, Ds^Ftp, Gs, Gs, Gs, Gs, Xu, Ww, Mm
Mm, Ww, Wwt, Ds, Gs, Gs, Gs, Gg, Gg, Gg, Gs, Ds, Wwrt, Ds, Gs, Gs, Gs^Em, Hh, Gs, Ds, Wwt, Ww, Mm
Mm, Xu, Xu, Ds, Gs, Gll^Uf, Hh, Hh, Gs, Gs, Ds, Ds, Wwt, Ds, Gs, Gs, Qxu, Gs, Gs, Ds, Xu, Xu, Mm
Mm, Xu, Xu, Xu, Gs, Gs, Qxu, Qxu, Gs, Ds^Es, Wwt, Wwt^Vm, Ds, Ds^Es, Gs, Qxu, Hh, Gs, Gs, Xu, Xu, Xu, Mm
Mm, Xu, Wwt, Ds, Gs, Gs, Gs^Em, Gs, Gs, Ds, Wwrt, Ds, Gs, Gs, Gg, Hh, Gs, Gll^Uf, Gs, Ds, Wwt, Xu, Mm
Mm, Ww, Xu, Ds, Gs, Hh, Gs, Gs, Ds^Ftp, Ds, Wwt, Ds, Gs, Gg, Ss, Gg, Gg, Gs, Gs, Ds, Xu, Ww, Mm
Mm, Ww, Xu, Gs, Gs, Gs, Gs, Ds^Ftp, Wwt, Wwt, Ds^Ftp, Ds^Ftp, Gs, Ss, Ss, Gll^Uf, Gg, Hh, Gs, Gs, Xu, Ww, Mm
Mm, Ww, Xu, Gs, Gs^Vd, Qxu, Gs, Ds, Wwt, Ds, Gs, Gs, Gll^Uf, Ss, Gg^Em, Gg, Gs, Hh, Hh, Gs, Xu, Ww, Mm
Mm, Ww, Xu, Gs, Hh, Qxu, Gs, Ds, Wwrt, Ds, Ds, Gs, Gs, Gg, Gs, Gs^Vd, Gs, Hh, Gs, Gs, Xu, Ww, Mm
Mm, Ww, Xu, Gs, Hh, Qxu, Gs, Ds, Ds, Wwt, Wwt, Ds^Ftp, Ds^Ftp, Gs, Gs, Gs, Qxu, Gs^Em, Gs, Uu, Ww, Ww, Mm
Mm, Ww, Xu, Gs, Gs, Gs^Em, Gs^Ft, Gs, Gs, Ds, Ds^Ftp, Wwt, Wwt, Ds, Ds, Gs, Gs, Qxu, Gs, Uu, Ww, Ww, Mm
Mm, Ww, Ww, Uu, Gs, Gs^Ft, Gs^Ft, Gg, Gll^Uf, Gs, Gs, Ds^Ftp, Ds, Wwt, Wwrt, Ds, Gs, Qxu, Gs, Uu, Xu, Ww, Mm
Mm, Ww, Ww, Uu, Gs, Gs^Ft, Gs, Gg, Ss, Ss, Gg, Gs, Gs, Ds, Wwt, Ds, Gs, Gs, Gll^Uf, Gs, Xu, Ww, Mm
Mm, Ww, Ww, Uu, Gs, Gs, Gg, Gg^Vd, Ss, Ss, Gs, Gs, Ds^Ftp, Ds, Wwt, Ds, Gs, Gg, Ss, Gg, Xu, Ww, Mm
Mm, Ww, Xu, Uu, Gs, Gs, Gll^Uf, Gg, Gs, Gs, Ds, Ds^Ftp, Wwt, Wwt, Ds^Ftp, Ds, Gs, Gg^Vd, Ss, Gg, Xu, Ww, Mm
Mm, Ww, Xu, Gs, Gs, Qxu, Qxu, Gs, Gs, Ds, Wwt^Ewl, Wwt, Wwt, Ds^Ftp, Gs, Gs, Ss, Ss, Gs, Gs, Xu, Ww, Mm
Mm, Ww, Wwt, Ds, Gs, Gs, Gs, Qxu, Gs, Ds, Cte, P2_Glider Wwt, Cte, Ds, Gs, Gg, Gll^Uf, Gg, Gs, Ds, Wwt, Ww, Mm
Mm, Xu, Wwt, Ds, Ds^Es, Ds^Ftp, Ds^Ftp, Ds, Ds, P2_Clasher Ds, Ds, 2 Cud^Kov, Ds, P2_Burner Ds, Gs, Gg, Gs, Gs, Ds, Ds^Es, Wwt, Xu, Mm
Mm, Xu, Mm, Wwt, Wwt, Wwt, Wwt, Wwt, Wwt, Wwt, Wwt, Wwt^Bsb|, Wwt, Ds^Es, Ds, Gs, Ds^Ftp, Ds, Wwt, Wwt, Mm, Xu, Mm
Mm, Mm, Mm, Mm, Mm, Hh, Hh^Vd, Hh, Hh, Hh, Ur, Ur, Hh, Wwt, Wwt, Ds^Ftp, Wwt, Wwt, Mm, Mm, Mm, Mm, Mm
Mm, Mm, Mm, Mm, Mm, Mm, Mm, Hh, Hh, Hh, Ur, Hh, Hh, Hh, Hh^Vd, Wwt, Mm, Mm, Mm, Mm, Mm, Mm, Mm
Mm, Mm, Mm, Mm, Mm, Mm, Mm, Mm, Mm, Hh, Mm, P2_Fighter Ur, Mm, Hh, Mm, Mm, Mm, Mm, Mm, Mm, Mm, Mm, Mm
Mm, Mm, Mm, Mm, Mm, Mm, Mm, Mm, Mm, Mm, Mm, Ur, Mm, Mm, Mm, Mm, Mm, Mm, Mm, Mm, Mm, Mm, Mm
