Mm, Mm, Mm, Mm, Mm, Mm, Mm, Mm, Mm, Mm, Mm, Ur, Mm, Mm, Mm, Mm, Mm, Mm, Mm, Mm, Mm, Mm, Mm
Mm, Mm, Mm, Mm, Mm, Mm, Mm^Vd, Mm, Mm, Mm, Mm^Vd, Ur, Mm, Mm, Mm, Mm, Mm^Vd, Mm, Mm, Mm, Mm, Mm, Mm
Mm, Gs, Gs, Gs, Gs, Gs, Gs, Gs, Gs, Gs, Ur, Ur, Ur, Gs, Gs, Gs, Gs, Gs, Gs, Gs, Gs, Gs, Mm
Mm, Gs, Gs, Gs, Gs, Gs, Gs, Gs, Gs, P2_Warrior Gs, Cte, 2 Cud^Kov, Cte, P2_Flare Gs, Gs, Gs, Gs, Gs, Gs, Gs, Gs, Gs, Mm
Mm, Gs, Gs, Gs, Rd, Rd, Rd, Gs, Gs, P2_Arbiter Gs, Gs, Cte, Gs, P2_Thrasher Gs, Gs, Gs, Rd, Rd, Rd, Gs, Gs, Gs, Mm
Mm, Gs, Gs, Rd, Qlf, Qlf, Qlf, Rd, Gs, Gs, Gs, P2_Sky Gs, Gs, Gs, Gs, Rd, Qxu, Qxu, Qxu, Rd, Gs, Gs, Mm
Mm, Dd, Dd, Rd, Qlf, Rr^Vd, Qlf, Rd, Gs, Gs, Gs, Gs, Gs, Gs, Gs, Rd, Qxu, Rr^Vd, Qxu, Rd, Gs, Gs, Mm
Mm, Dd, Gs, Dd, Dd, Qlf, Rd, Rd, Gs^Ft, Gs, Gs^Ft, Gs, Gs^Ft, Gs, Gs^Ft, Rd, Rd, Qxu, Rd, Rd, Gs, Gs, Mm
Mm, Gs, Gs, Gs, Gs, Dd, Dd, Gs^Ft, Gs, Gs^Ft, Gs, Gs, Gs, Gs^Ft, Gs, Gs^Ft, Gs, Rd, Gs^Ft, Gs, Gs^Ft, Gs^Ft, Mm
Mm, Gs, Gs, Gs, Gs, Gs, Gs, Dd, Gs, Gs, Wwt, Gs, Gs, Gs, Gs, Dd, Gs, Gs, Rd, Gs^Ft, Gs, Gs^Ft, Mm
Mm, Gs, Gs, Gs, Qxu, Gs, Gs, Dd, Gs, Wwt, Gs, Gs^Do, Gs^Uf, Gs^Uf, Gs, Dd, Rd, Rd, Qlf, Rd, Rd, Gs, Mm
Mm, Gs, Gs, Qxu, Rr^Vd, Qxu, Gs, Dd, Gs, Gs, Gs, Gs, Gs, Gs, Gs, Dd, Rd, Qlf, Rr^Vd, Qlf, Rd, Gs, Mm
Mm, Gs, Gs, Qxu, Qxu, Qxu, Rd, Dd, Dd, Gs, Gs, Hh, Hh, Gs, Dd, Dd, Rd, Qlf, Qlf, Qlf, Rd, Gs, Mm
Mm, Gs, Uu, Gs, Uu, Gs, Gs, Hd, Hd, Dd, Hh, Hh, Gs, Dd, Gs^Ft, Gs^Ft, Gs, Rd, Rd, Rd, Gs, Gs, Mm
Mm, Uu, Uu, Uu, Uu, Uu, Xu, Gs, Gs, Gs, Rd, Hhd, Rd, Gs, Gs, Gs, Wwt, Wwt, Wwt, Wwt, Wwt, Wwt, Mm
Mm, Uu, Gs, Uu, Gs, Uu, Gs, Xu, Xu, Rd, Qlf, Qlf, Qlf, Rd, Wwt, Wwt, Gs, Gs, Gs^Uf, Gs, Gs, Gs, Mm
Mm, Gs, Dd, Dd, Gs^Do, Gs, Hh, Gs, Rd, Xu, Qlf, Qlf, Qlf, Qlf, Rd, Gs, Gs, Gs^Uf, Gs, Gs, Gs, Gs, Mm
Mm, Gs, Gs, Dd, Gs, Hh, Gs, Gs, Rd, Qlf, Qlf, Rr, Qlf, Qlf, Rd, Gs, Hh, Hh, Gs^Do, Dd, Dd, Gs, Mm
Mm, Gs, Gs, Gs, Gs^Uf, Gs^Uf, Gs, Gs, Wwt, Qlf, Qlf, Qlf, Qlf, Xu, Xu, Gs, Gs, Gs, Gs, Dd, Gs, Gs, Mm
Mm, Gs, Wwt, Gs, Wwt, Gs, Wwt, Wwt, Gs, Rd, Rd, Qlf, Rd, Rd, Gs, Xu, Xu, Uu, Uu, Uu, Uu, Uu, Mm
Mm, Wwt, Gs, Wwt, Rd, Wwt, Gs, Gs, Gs^Ft, Gs, Gs, Hhd, Hh, Gs, Hd, Gs, Gs, Uu, Uu, Uu, Uu, Uu, Mm
Mm, Gs, Rd, Rd, Qlf, Rd, Rd, Gs^Ft, Dd, Dd, Hh, Hh, Gs, Dd, Dd, Hd, Gs, Gs, Qxu, Gs, Gs, Gs, Mm
Mm, Gs, Rd, Qlf, Rr^Vd, Qlf, Rd, Dd, Gs, Gs, Gs, Hh, Gs, Gs, Gs, Dd, Gs, Qxu, Rr^Vd, Qxu, Gs, Gs, Mm
Mm, Gs, Rd, Qlf, Qlf, Qlf, Rd, Dd, Gs, Gs, Gs^Uf, Gs, Gs, Gs, Gs, Dd, Gs, Qxu, Qxu, Qxu, Gs, Gs, Mm
Mm, Gs, Gs, Rd, Rd, Rd, Gs, Dd, Gs, Gs^Uf, Gs, Gs^Do, Wwt, Wwt, Gs, Dd, Gs, Gs, Gs, Gs, Gs, Gs, Mm
Mm, Gs^Ft, Gs^Ft, Gs^Ft, Gs^Ft, Gs, Gs, Dd, Gs, Gs, Gs, Gs, Gs, Gs, Gs, Dd, Dd, Gs, Gs, Gs, Gs, Gs, Mm
Mm, Gs^Ft, Gs, Gs, Gs, Gs, Gs, Gs^Ft, Gs^Ft, Gs^Ft, Gs^Ft, Gs, Gs^Ft, Gs^Ft, Gs^Ft, Gs^Ft, Rd, Dd, Dd, Gs, Gs, Gs, Mm
Mm, Gs, Gs, Gs, Qxu, Qxu, Qxu, Gs, Gs, Gs, Gs, Gs, Gs, Gs, Gs, Rd, Qlf, Qlf, Qlf, Dd, Dd, Dd, Mm
Mm, Gs, Gs, Gs, Qxu, Rr^Vd, Qxu, Gs, Gs, Gs, Gs, Gs, Gs, Gs, Gs, Rd, Qlf, Rr^Vd, Qlf, Rd, Gs, Dd, Mm
Mm, Gs, Gs, Gs, Gs, Qxu, Gs, Gs, Gs, Gs, Gs, P1_Sky Gs, Gs, Gs, Gs, Rd, Rd, Qlf, Rd, Rd, Gs, Gs, Mm
Mm, Gs, Gs, Gs, Gs, Gs, Gs, Gs, Gs, P1_Thrasher Gs, Cte, Cte, Cte, P1_Arbiter Gs, Gs, Gs, Gs, Rd, Gs, Gs, Gs, Gs, Mm
Mm, Gs, Gs, Gs, Gs, Gs, Gs, Gs, Gs, P1_Fire Gs, Ur, 1 Cud^Kov, Ur, P1_Warrior Gs, Gs, Gs, Gs, Gs, Gs, Gs, Gs, Gs, Mm
Mm, Gs, Mm, Gs, Mm, Gs, Mm^Vd, Gs, Mm, Gs, Mm, Ur, Mm^Vd, Gs, Mm, Gs, Mm^Vd, Gs, Mm, Gs, Mm, Gs, Mm
Mm, Mm, Mm, Mm, Mm, Mm, Mm, Mm, Mm, Mm, Mm, Ur, Mm, Mm, Mm, Mm, Mm, Mm, Mm, Mm, Mm, Mm, Mm
Mm, Mm, Mm, Mm, Mm, Mm, Mm, Mm, Mm, Mm, Mm, Ur, Mm, Mm, Mm, Mm, Mm, Mm, Mm, Mm, Mm, Mm, Mm
