Mm, Mm, Mm, Mm, Mm, Mm, Mm, Mm, Mm, Mm, Mm, Ur, Mm, Mm, Mm, Mm, Mm, Mm, Mm, Mm, Mm, Mm, Mm
Mm, Mm, Mm, Mm, Mm, Mm, Mm, Mm, Hh^Vd, Hh, Hh, Ur, Ur, Hh^Vd, Hh, Mm, Mm, Mm, Mm, Mm, Mm, Mm, Mm
Mm, Mm, Mm, Mm, Mm, Mm, Wwt, Wwt, Wwt, Hh, Hh, Hh, Ur, Hh, Hh, Hh, Hh^Vd, Mm, Mm, Mm, Mm, Mm, Mm
Mm, Mm, Mm, Mm, Wwt, Wwt, Ds, Ds^Ftp, Ds, Wwt, Wwt, Ur, Wwt, Hh, Wwt, Hh, Wwt, Hh, Wwt, Mm, Mm, Mm, Mm
Mm, Xu, Wwt, Wwt, Ds, Ds, Gs, Gs, Gs, Ds, Ds, Wwt^Bsb|, Ds, Wwt, Ds, Wwt, Ds, Wwt, Ds, Wwt, Wwt, Xu, Mm
Mm, Xu, Wwt, Ds, Gs, Gs, Gs^Ft, Gs, Gs, P2_Warrior Ds, Cte, 2 Cud^Kov, Cte, P2_Flare Ds, Gs, Ds^Ftp, Gs, Ds, Gs, Ds, Wwt, Xu, Mm
Mm, Wwt, Xu, Ds, Gs, Gs, Gs, Gs, Gs, P2_Arbiter Ds, Wot, P2_Sky Wot, Wot, P2_Thrasher Ds, Gs, Gs, Gs, Gs, Gs, Ds, Xu, Wwt, Mm
Mm, Wwt, Xu, Gs, Gs, Gs, Gs, Gs, Ds^Ftp, Ds, Wwt, Wot, Ds, Ds, Gs, Gs^Uf, Gs, Gs^Ft, Gs, Gs, Xu, Wwt, Mm
Mm, Wwt, Xu, Gs, Gs, Gs^Vd, Gs, Ds, Wwt, Wwt, Ds, Ds^Ftp, Gs, Gs, Gs, Gs, Gs, Gs, Gs, Gs, Xu, Wwt, Mm
Mm, Wwt, Xu, Gs, Gs, Gs, Gs, Ds, Wwt, Ds, Gs, Gs, Gs^Ft, Gs, Gs, Gs^Vd, Gs, Gs, Gs, Gs, Xu, Wwt, Mm
Mm, Wwt, Xu, Gs, Gs^Uf, Gs, Gs, Ds, Wwrt, Ds, Ds, Gs, Gs, Gs, Hh, Gs, Gs, Gs^Ft, Gs, Gs, Xu, Wwt, Mm
Mm, Wwt, Xu, Gs, Gs, Gs, Gs, Ds, Ds, Wwt, Wwt, Ds, Ds^Ftp, Gs, Gs, Gs, Gs, Gs, Gs, Gs, Xu, Wwt, Mm
Mm, Wwt, Xu, Gs, Gs, Gs, Ss, Gs, Gs, Ds, Ds^Ftp, Wwt, Wwt, Ds, Ds, Gs, Gs, Gs, Gs, Gs, Xu, Wwt, Mm
Mm, Wwt, Xu, Gs, Hh, Gs, Gs, Gs, Gs, Gs, Gs, Ds, Ds, Wwt, Wwrt, Ds, Gs, Ss, Gs, Gs, Xu, Wwt, Mm
Mm, Wwt, Xu, Gs, Gs, Gs, Gs, Gs^Vd, Gs, Gs, Gs^Ft, Gs, Gs, Ds, Wwt, Ds, Gs, Gs, Gs^Vd, Gs, Xu, Wwt, Mm
Mm, Wwt, Xu, Gs, Gs, Gs, Gs, Gs, Ss, Gs, Gs, Gs, Ds^Ftp, Ds, Wwt, Ds, Gs, Gs, Gs, Gs, Xu, Wwt, Mm
Mm, Wwt, Xu, Gs, Gs, Gs^Ft, Gs, Gs, Gs, Gs, Gs, Ds, Wwt, Wwt, Ds^Ftp, Ds, Gs, Gs, Gs, Gs, Xu, Wwt, Mm
Mm, Wwt, Wwt, Ds, Gs, Gs, Gs, Gs, Gs, Gs, Ds, Ds, Wwrt, Ds, Gs, Gs, Gs, Ss, Gs, Ds, Wwt, Wwt, Mm
Mm, Xu, Xu, Ds, Gs, Gs, Gs, Hh, Gs, Ds, Wwt^Bsb\, Wwt, Wwt, Ds, Gs, Gs, Gs^Uf, Gs, Gs, Ds, Xu, Xu, Mm
Mm, Xu, Xu, Xu, Gs, Gs, Gs^Uf, Gs, Gs, Ds, Wwt, Ds^Vd, Wwt^Bsb\, Ds, Gs, Gs, Gs, Gs, Gs, Xu, Xu, Xu, Mm
Mm, Xu, Wwt, Ds, Gs, Gs, Gs, Gs, Gs, Ds, Wwrt, Wwt, Ds, Ds, Gs, Hh, Gs, Gs, Gs, Ds, Wwt, Xu, Mm
Mm, Wwt, Xu, Ds, Gs, Ss, Gs, Gs, Ds^Ftp, Ds, Wwt, Ds, Gs, Gs, Gs, Gs, Gs, Gs, Gs, Ds, Xu, Wwt, Mm
Mm, Wwt, Xu, Gs, Gs, Gs, Gs, Ds, Wwt, Wwt, Ds^Ftp, Ds, Gs, Gs, Ss, Gs, Gs, Gs^Ft, Gs, Gs, Xu, Wwt, Mm
Mm, Wwt, Xu, Gs, Gs^Vd, Gs, Gs, Ds, Wwt, Ds, Gs, Gs, Gs^Ft, Gs, Gs, Gs, Gs, Gs, Gs, Gs, Xu, Wwt, Mm
Mm, Wwt, Xu, Gs, Gs, Gs, Gs, Ds, Wwrt, Ds, Ds, Gs, Gs, Gs, Gs, Gs^Vd, Gs, Gs, Hh, Gs, Xu, Wwt, Mm
Mm, Wwt, Xu, Gs, Gs, Ss, Gs, Ds, Ds, Wwt, Wwt, Ds, Ds^Ftp, Gs, Gs, Gs, Ss, Gs, Gs, Gs, Xu, Wwt, Mm
Mm, Wwt, Xu, Gs, Gs, Gs, Gs, Gs, Gs, Ds, Ds^Ftp, Wwt, Wwt, Ds, Ds, Gs, Gs, Gs, Gs, Gs, Xu, Wwt, Mm
Mm, Wwt, Xu, Gs, Gs, Gs, Gs, Gs, Hh, Gs, Gs, Ds, Ds, Wwt, Wwrt, Ds, Gs, Gs, Gs^Uf, Gs, Xu, Wwt, Mm
Mm, Wwt, Xu, Gs, Gs, Gs^Ft, Gs, Gs, Gs, Gs, Gs^Ft, Gs, Gs, Ds, Wwt, Ds, Gs, Gs, Gs, Gs, Xu, Wwt, Mm
Mm, Wwt, Xu, Gs, Gs, Gs, Gs, Gs^Vd, Gs, Gs, Gs, Gs, Ds, Ds, Wwt, Ds, Gs, Gs, Gs, Gs, Xu, Wwt, Mm
Mm, Wwt, Xu, Gs, Gs, Gs, Gs, Gs, Gs, Gs, Ds, Ds^Ftp, Wwt, Wwt, Ds^Ftp, Ds, Gs, Gs^Vd, Gs, Gs, Xu, Wwt, Mm
Mm, Wwt, Xu, Gs, Gs, Gs^Ft, Gs, Gs^Uf, Gs, Ds, Wot, Wot, Wot, Ds, Gs, Gs, Gs, Gs, Gs, Gs, Xu, Wwt, Mm
Mm, Wwt, Wwt, Ds, Gs, Gs, Gs, Gs, Gs, P1_Thrasher Ds, Cte, P1_Sky Wot, Cte, P1_Arbiter Ds, Gs, Gs, Gs^Ft, Gs, Gs, Ds, Wwt, Wwt, Mm
Mm, Xu, Wwt, Ds, Ds, Ds, Ds, Ds^Ftp, Ds, P1_Fire Ds, Ds, 1 Cud^Kov, Ds, P1_Warrior Ds, Gs, Gs, Gs, Gs, Ds, Ds, Wwt, Xu, Mm
Mm, Xu, Mm, Wwt, Wwt, Wwt, Wwt, Wwt, Wwt, Wwt, Wwt, Wwt^Bsb|, Wwt, Ds, Ds, Gs, Ds, Ds, Wwt, Wwt, Mm, Xu, Mm
Mm, Mm, Mm, Mm, Mm, Hh, Hh^Vd, Hh, Hh, Hh, Ur, Ur, Hh, Wwt, Wwt, Ds^Ftp, Wwt, Wwt, Mm, Mm, Mm, Mm, Mm
Mm, Mm, Mm, Mm, Mm, Mm, Mm, Hh, Hh, Hh, Ur, Hh, Hh, Hh, Hh^Vd, Wwt, Mm, Mm, Mm, Mm, Mm, Mm, Mm
Mm, Mm, Mm, Mm, Mm, Mm, Mm, Mm, Mm, Hh^Vd, Mm, Ur, Mm, Hh, Mm, Mm, Mm, Mm, Mm, Mm, Mm, Mm, Mm
Mm, Mm, Mm, Mm, Mm, Mm, Mm, Mm, Mm, Mm, Mm, Ur, Mm, Mm, Mm, Mm, Mm, Mm, Mm, Mm, Mm, Mm, Mm
