Ww, Ww, Ww, Ww, Ww, Ww, Ww, Ww, Ww, Ww, Ww, Ww, Ww, Ww, Ww, Ww, Ww, Ww, Ww, Ww, Wo, Ww, Wo, Wo, Wo, Wo, Wo, Wo, Wo, Wo, Wo, Wo, Wo, Wo, Wo, Wo, Wo, Wo, Wo, Wo, Wo, Wo, Wo, Wo, Wo, Ww
Ww, Ww, Ww, Ww, Ww, Ww, Ww, Ww, Ww, Ww, Ww, Ww, Ww, Ww, Ww, Ww, Ww, Ww, Ww, Ww, Ww, Wo, Ww, Wo, Wo, Wo, Ww, Wo, Ww, Wo, Ww, Wo, Ww, Wo, Ww, Wo, Wo, Wo, Wo, Wo, Wo, Wo, Wo, Wo, Wo, Wo
Ww, Ww, Ds, Ww, Ds, Ww, Ww, Ww, Ww, Ww, Ww, Ww, Ww, Ww, Ww, Ww, Ds, Ww, Ww, Ww, Ww, Ww, Ww, Ww, Ww, Ww, Ww, Ww, Gg, Ww, Ww, Ww, Ww, Ww, Ww, Ww, Ww, Wo, Ww, Wo, Ww, Ww, Ww, Ww, Ww, Ww
Ww, Ww, Ds, Gg, Gg, Gg, Gg, Ds, Gg, Ds, Ds, Ds, Ds, Ww, Ww, Ds, Ww, Ds, Ds, Ds, Ds, Ww, Ww, Ww, Ww, Ww, Ww, Ww, Ww, Ww, Ds, Ww, Ds, Ww, Ds, Ww, Ww, Ww, Ww, Ww, Ww, Ww, Ww, Ww, Ww, Ww
Ww, Ww, Ww, Gg, Gg, Gg, Gg, Gg, Gg, Gg, Gg, Ds, Gg, Ds, Ds, Ww, Ww, Ds, Gg, Gg, Gg, Ds, Ds, Ds, Gg, Ww, Ds, Ds, Gg, Ds, Gg, Ds, Gg^Vh, Gg, Gg, Ds, Ds, Ww, Ds, Ww, Ds, Ww, Ds, Ds, Ww, Ww
Ww, Ww, Ww, Ds, Gg, Gg, Chr, Chr, Chr, Rd, Rd, Gg, Gg, Gg, Gg, Ds, Gg, Ds, Gg, Gg, Gg, Gg, Gg, Gg, Gg, Gg, Gg, Gg, Re^Gvs, Gg, Re^Gvs, Gg, Re^Gvs, Gg, Gg, Gg, Gg, Gg, Gg, Ds, Gg, Gg^Vh, Gg, Ds, Ww, Ww
Ww, Ww, Ww, Ww, Ds, Gg, Chr, 1 Khr, Chr, Gs^Fds, Gs^Fds, Rd, Rd, Gg, Rd, Gg, Gg, Gg, Gg, Gg, Gg, Gg, Gg, Gg, Gg, Gg, Gg, Gg, Gg, Re^Gvs, Re^Gvs, Re^Gvs, Re^Gvs, Re^Gvs, Gg, Gg, Gg, Gg, Re^Gvs, Gg, Re^Gvs, Gg, Gg, Gg, Gg, Ds
Ww, Ww, Ww, Ww, Ds, Gg, Gg, Chr, Gs^Fds, Gs^Fds, Gs^Fds, Hh^Fms, Hh^Fms, Rd, Hh^Fms, Rp, Rd, Rd, Rp, Gg, Rp, Gg, Gg^Vh, Gg, Gg, Gg, Gg, Gg, Gg^Vh, Gg, Re^Gvs, Re^Gvs, Re^Gvs, Gg, Gg, Re^Gvs, Re^Gvs, Re^Gvs, Re^Gvs, Re^Gvs, Re^Gvs, Gg, Gg, Gg, Gg, Gg
Ww, Wwr, Ww, Ww, Ww, Ds, Ds, Rp, Gg, Gs^Fds, Gs^Fds, Hh^Fms, Hh^Fms, Hh^Fms, Mm, Hh^Fms, Hh^Fms, Hh^Fms, Hh^Fms, Rd, Hh^Fms, Rp, Rp, Rd, Rd, Rd, Rd, Rd, Rd, Rd, Rd, Gg, Gg, Gg, Gg^Vh, Gg, Re^Gvs, Re^Gvs, Re^Gvs, Re^Gvs, Re^Gvs, Re^Gvs, Gg, Gg, Gg, Gg
Ww, Wwr, Wwr, Ww, Ww, Ww, Ds, Rp, Rp, Gs^Fds, Gg, Gs^Fms, Gs^Fds, Hh^Fms, Hh^Fms, Mm, Mm, Hh^Fms, Mm, Hh^Fms, Mm, Hh^Fms, Hh^Fms, Hh^Fms, Hh^Fms, Hh^Fms, Hh^Fms, Hh^Fms, Hh^Fms, Hh^Fms, Hh^Fms, Rp, Rp, Rp, Rp, Gg, Gg, Re^Gvs, Re^Gvs, Re^Gvs, Re^Gvs, Re^Gvs, Gg, Gg, Rp, Gg
Ww, Wwr, Wwr, Ww, Ww, Ww, Ww, Ds, Ds, Rp, Rp, Gg, Gg, Gs^Fms, Gs^Fds, Hh^Fms, Hh^Fms, Mm, Hh^Fms, Mm, Mm, Mm, Mm, Mm, Mm, Mm, Mm, Mm, Mm, Hh^Fms, Hh^Fms, Gg, Gg, Gg, Gg, Rp, Rp, Gg, Rp, Gg, Rp, Gg, Rp, Rp, Gg, Rp
Ww, Ww, Wwr, Wwr, Wwr, Ww, Ww, Ww, Ds, Gg, Rp, Gg, Gg, Gg, Gg, Gs^Fms, Gg, Hh^Fms, Gs^Fds, Hh^Fms, Hh^Fms, Hh^Fms, Gg, Hh^Fms, Hh^Fms, Mm, Hh^Fms, Mm, Mm, Mm, Mm, Hh^Fms, Hh^Fms, Gg, Gg, Gg, Gg, Rp, Gg, Rp, Gg, Rp, Hh^Fms, Gg, Hh^Fms, Gg
Ww, Ww, Ww, Ww, Wwr, Ww, Ww, Ww, Gg, Gg, Rp, Gg, Gs^Fms, Gg, Gs^Fds, Gg, Re^Gvs, Gs^Fms, Gs^Fds, Hh^Fms, Gg, Gs^Fds, Gs^Fds, Hh^Fms, Hh^Fms, Hh^Fms, Hh^Fms, Hh^Fms, Mm^Vhh, Mm, Mm, Mm, Hh^Fms, Hh^Fms, Hh^Fms, Hh^Fms, Hh^Fms, Gg^Vh, Hh^Fms, Hh^Fms, Hh^Fms, Hh^Fms, Mm, Hh^Fms, Gg, Hh^Fms
Ww, Ww, Ww, Ww, Wwr, Wwr, Ww, Ww, Ds, Gg, Rp, Gs^Fms, Gg, Gs^Fms, Gs^Fms, Gs^Fms, Re^Gvs, Gg, Gs^Fms, Gs^Fms, Gg, Gs^Fds, Gs^Fms, Gg, Gs^Fms, Gs^Fds, Gs^Fms, Hh^Fms, Hh^Fms, Mm, Mm, Mm, Mm, Mm, Mm, Hh^Fms, Mm, Hh^Fms, Mm, Mm, Mm, Mm, Mm, Mm, Mm, Gg
Wo, Ww, Ww, Ww, Wwr, Wwr, Ww, Ww, Ww, Ds, Rp, Gg, Gs^Fds, Gs^Fds, Gg, Re^Gvs, Re^Gvs, Gg^Ve, Gs^Fms, Gs^Fds, Gs^Fms, Gg, Gg, Gg, Gs^Fds, Gg, Gg, Gs^Fds, Hh^Fms, Hh^Fms, Hh^Fms, Mm, Mm, Mm, Mm, Mm, Mm, Mm, Mm, Mm, Mm, Mm, Mm, Mm, Hh^Fms, Gg
Wo, Wo, Ww, Ww, Wwr, Wwr, Ww, Ww, Ww, Ww, Ww^Bw|, Ww, Ww, Ww, Ww, Gs^Fds, Ww, Gs^Fds, Gs^Fds, Gs^Fds, Gs^Fds, Gs^Fds, Gs^Fms, Gg, Gg, Gg, Gs^Fds, Gs^Fms, Gg, Gs^Fms, Gs^Fds, Hh^Fms, Hh^Fms, Mm, Mm, Mm, Mm, Mm, Mm, Gg, Mm, Mm, Hh^Fms, Hh^Fms, Hh^Fms, Gg
Wo, Wo, Ww, Ww, Wwr, Ww, Ww, Ww, Ww, Ww, Rp, Gs^Fms, Gs^Fms, Gs^Fms, Gs^Fms, Ww, Ww, Ww, Ww, Ww, Ww, Ww, Ww, Gs^Fms, Gs^Fds, Gs^Fds, Gg, Gg, Gg, Gs^Fms, Gg, Hh^Fms, Hh^Fms, Hh^Fms, Hh^Fms, Mm, Mm, Mm, Mm, Mm, Mm, Mm, Mm, Hh^Fms, Hh^Fms, Hh^Fms
Ww, Ww, Ww, Ww, Wwr, Wwr, Wwr, Ww, Ww, Ds, Ds, Rp, Rp, Gs^Fms, Gs^Fds, Gs^Fms, Gs^Fds, Gs^Fms, Gs^Fds, Gs^Fds, Gs^Fms, Gs^Fms, Gs^Fms, Ww, Ww, Ww, Ww, Gs^Fms, Ww, Gs^Fms, Ww, Gs^Fds, Gs^Fms, Hh^Fms, Hh^Fms, Mm, Mm, Mm, Mm, Mm, Mm, Mm, Mm, Mm, Mm, Hh^Fms
Ww, Ww, Ww, Gg, Gg, Wwr, Wwr, Ww, Ww, Ww, Ds, Gg, Rp, Gg^Ve, Gg, Gs^Fds, Gg, Gs^Fds, Gg^Vh, Gg, Gs^Fds, Gs^Fms, Gg, Gs^Fms, Gg, Gs^Fms, Gs^Fds, Ww, Gs^Fms, Ww, Ww, Ww, Ww, Gs^Fms, Ww, Hh^Fms, Hh^Fms, Mm, Ww, Hh, Hh, Mm, Mm, Mm, Mm, Gg
Ww, Ww, Ww, Gg, Gg, Ww, Gg, Ww, Ww, Ww, Ds, Gg, Rp, Gg, Re^Gvs, Gg, Gs^Fms, Gg, Gg, Gs^Fds, Gs^Fds, Gs^Fms, Gg, Gg, Gs^Fms, Gg, Gg, Gg, Gs^Fms, Gs^Fms, Gs^Fms, Ww, Hh^Fms, Ww, Hh^Fms, Ww, Ww, Ww, Ww, Ww, Ww, Hh, Hh, Mm, Mm, Mm
Wo, Wo, Ww, Ww, Ww, Ww, Ww, Ww, Ww, Ww, Ds, Gg, Rp, Gs^Fms, Gs^Fms, Gg, Gs^Fds, Re^Gvs, Gg, Gs^Fds, Gg, Gs^Fms, Gs^Fms, Gs^Fms, Gg, Gs^Fds, Gs^Fms, Gs^Fms, Gs^Fms, Hh^Fms, Hh^Fms, Hh^Fms, Mm, Hh^Fms, Hh^Fms, Hh, Hh^Fms, Hh, Hh, Hh, Hh, Ww, Mm, Mm, Mm, Mm
Wo, Wo, Ww, Ww, Ww, Ww, Ww, Wwr, Ww, Ww, Ww, Ds, Ds, Rp, Gs^Fms, Gg, Re^Gvs, Re^Gvs, Re^Gvs, Gg, Gg, Gs^Fds, Gg, Gs^Fds, Gs^Fds, Gs^Fds, Gs^Fds, Gs^Fms, Mm, Hh^Fms, Hh^Fms, Mm, Mm, Mm, Mm, Mm, Mm, Mm, Mm, Mm, Mm, Hh, Mm, Mm, Mm, Mm
Wo, Wo, Wo, Ww, Ww, Ww, Ww, Gg, Gg, Ww, Ww, Ww, Ds, Rp, Gg^Ve, Gs^Fms, Re^Gvs, Re^Gvs, Gs^Fms, Gg, Gs^Fms, Gs^Fds, Gg, Gs^Fms, Re^Gvs, Gs^Fms, Gs^Fms, Mm, Mm, Mm, Mm, Hh^Fms, Mm, Mm, Mm, Mm, Mm, Mm, Mm, Mm, Mm, Mm, Mm, Mm, Mm, Gg
Wo, Wo, Wo, Ww, Ww, Ww, Ww, Ww, Ww, Ww, Ww, Ww, Gg, Rp, Rp, Gs^Fds, Gs^Fms, Gs^Fms, Gg, Gg, Gs^Fds, Gg^Ve, Re^Gvs, Re^Gvs, Re^Gvs, Gg, Gs^Fms, Hh^Fms, Hh^Fms, Mm, Hh^Fms, Hh^Fms, Mm, Mm, Mm, Mm, Mm, Mm, Mm, Mm, Mm, Mm, Mm, Mm, Mm, Gg
Wo, Wo, Wo, Ww, Ww, Ww, Ww, Ww, Ww, Ww, Ww, Ww, Ww, Ds, Gg, Rp, Gg, Gg, Gs^Fms, Gs^Fms, Gg, Re^Gvs, Re^Gvs, Re^Gvs, Gg, Gs^Fms, Gg, Gs^Fds, Hh^Fms, Hh^Fms, Hh^Fms, Mm, Mm^Vhh, Mm, Mm, Mm, Mm, Mm, Ww, Mm, Mm, Mm, Mm, Mm, Mm, Mm
Wo, Wo, Wo, Wo, Ww, Ww, Ww, Ww, Ds, Ww, Wwr, Ww, Ww, Ds, Gg, Rp, Gs^Fms, Gg, Gg, Gs^Fms, Gg, Gs^Fms, Gs^Fms, Gs^Fms, Gs^Fms, Gg, Gg, Gs^Fms, Gs^Fds, Gs^Fms, Gs^Fms, Hh^Fms, Hh^Fms, Mm, Mm, Mm, Ww, Ww, Mm, Mm, Mm, Mm, Mm, Mm, Mm, Gg
Wo, Wo, Wo, Ww, Ww, Ww, Ww, Gg, Gg, Ds, Ww, Wwr, Ww, Ds, Gg, Rp, Rp, Gg^Ve, Gs^Fms, Gs^Fds, Gg, Gg, Gg, Re^Gvs, Re^Gvs, Gs^Fms, Gs^Fms, Gs^Fms, Gs^Fms, Gs^Fds, Gs^Fms, Hh^Fms, Hh^Fms, Hh^Fms, Hh^Fms, Ww, Ww, Mm, Mm, Mm, Mm, Mm, Mm, Mm, Mm, Mm
Wo, Wo, Wo, Wo, Ww, Ww, Ww, Gg, Gg, Gg, Ww, Wwr, Ww, Ds, Gg, Gs^Fms, Gs^Fms, Rp, Rp, Gs^Fms, Gg, Gs^Fms, Gg, Gs^Fds, Re^Gvs, Gs^Fds, Gs^Fms, Re^Gvs, Gg, Gs^Fms, Gs^Fms, Gg, Ww, Gg, Ww, Ww, Hh^Fms, Mm, Mm, Mm, Mm, Mm, Cud, Mm, Mm, Mm
Wo, Wo, Wo, Wo, Ww, Ww, Ww, Gg, Gg, Gg, Ww, Ww, Ww, Ww, Ww, Gg, Gg, Gs^Fds, Gs^Fds, Rp, Rp, Gg, Gs^Fms, Gs^Fds, Re^Gvs, Gg^Vh, Gg, Gg, Ww, Gg, Ww, Ww, Rp, Ww, Rp, Gs^Fds, Gg, Hh^Fms, Hh^Fms, Mm, Mm, Cud, 2 Kud, Cud, Mm, Gg
Wo, Wo, Wo, Wo, Ww, Ww, Ww, Ww, Gg, Gg, Gg, Ww, Ww, Ww, Ww, Ds, Ds, Gg, Gg, Gs^Fds, Gs^Fds, Rp, Gs^Fms, Gs^Fms, Gs^Fds, Gg, Ww, Ww, Rp, Ww, Rp, Rp, Gs^Fms, Rp, Gs^Fms, Rp, Rp, Rp, Rp, Rp, Rp, Cud, Cud, Cud, Rp, Gg
Wo, Wo, Ww, Ww, Ww, Ww, Ww, Ww, Gg, Gg^Vh, Gg, Ww, Ww, Ww, Ww, Ds, Ds, Gg, Gg, Gs^Fms, Gg, Rp, Rp, Gs^Fms, Ww, Ww, Rp, Rp, Gg, Rp, Gs^Fms, Gs^Fds, Gg^Ve, Gs^Fms, Gs^Fds, Gg^Ve, Re^Gvs, Gs^Fds, Gg, Gs^Fms, Hh^Fms, Hh^Fms, Mm, Mm, Mm, Gg
Ww, Ww, Ww, Ww, Ww, Ww, Ww, Ww, Gg, Gg, Gg, Gg, Gg, Wwr, Ww, Ww, Ww, Gg, Gs^Fms, Gs^Fds, Ww, Ww, Ww, Ww^Bw\, Ww^Bw|, Rp, Gs^Fms, Gs^Fms, Gs^Fms, Gs^Fds, Gg, Gs^Fds, Gs^Fms, Gs^Fms, Gg, Re^Gvs, Re^Gvs, Re^Gvs, Re^Gvs, Gs^Fds, Hh^Fms, Hh^Fms, Hh^Fms, Mm, Mm, Gg
Ww, Ww, Ww, Ww, Ww, Ww, Ww, Gg, Ww, Gg, Ww, Gg, Ww, Wwr, Wwr, Ww, Ww, Ds, Ww, Ww, Gs^Fms, Ww, Gs^Fms, Gs^Fms, Rp, Gg, Gs^Fds, Gs^Fms, Gg, Gs^Fds, Gg, Gs^Fms, Gs^Fms, Gs^Fds, Gs^Fds, Gs^Fms, Gg, Re^Gvs, Re^Gvs, Gs^Fms, Gg, Hh^Fms, Hh^Fms, Mm, Mm, Mm
Wo, Wo, Wo, Wo, Ww, Ww, Ww, Ww, Ww, Ww, Ww, Gg, Ww, Ww, Wwr, Ww, Ww, Ww, Ds, Gs^Fms, Gs^Fms, Gg, Re^Gvs, Re^Gvs, Re^Gvs, Rp, Gg^Ve, Gs^Fds, Gs^Fms, Gs^Fds, Re^Gvs, Re^Gvs, Re^Gvs, Gs^Fms, Gg, Gs^Fds, Gg, Gs^Fds, Re^Gvs, Re^Gvs, Gs^Fds, Gg^Ve, Gs^Fms, Hh^Fms, Hh^Fms, Mm
Wo, Wo, Wo, Wo, Wo, Ww, Ww, Ww, Ww, Ww, Ww, Ww, Ww, Ww, Ww, Ww, Ww, Ww, Gs^Fms, Gs^Fms, Gs^Fms, Gg, Gs^Fms, Re^Gvs, Gs^Fms, Rp, Gs^Fms, Gs^Fms, Gs^Fms, Gg, Gs^Fms, Re^Gvs, Gs^Fms, Re^Gvs, Gs^Fms, Gs^Fms, Gs^Fms, Gs^Fms, Gs^Fms, Gs^Fms, Gs^Fms, Gs^Fms, Gs^Fms, Gs^Fms, Hh^Fms, Gg
