border_size=1
usage=map

Wot         , Wot         , Wot         , Wot         , Wot         , Wot         , Wot         , Wot         , Wot         , Wot         , Wot         , Wot         , Wot         , Wot         , Wot         , Wot         , Wot         , Wot         , Wot         , Wot         , Wot         , Wot         , Wot         , Wot         , Wot         , Wot         , Wot         , Wot         , Wot         , Wot         , Wot         , Wot         , Wot         
Wot         , Wot         , Wot         , Wot         , Wot         , Wot         , Wot         , Wot         , Wot         , Wot         , Wot         , Wot         , Wot         , Wot         , Wot         , Wot         , Wot         , Wot         , Wot         , Wot         , Wot         , Wot         , Wot         , Wot         , Wot         , Wot         , Wot         , Wot         , Wot         , Wot         , Wot         , Wot         , Wot         
Wot         , Wot         , Wot         , Wot         , Wot         , Wot         , Wot         , Wot         , Wot         , Wot         , Wot         , Wot         , Wwt         , Wot         , Wwt         , Wot         , Wwt         , Wot         , Wot         , Wot         , Wot         , Wot         , Wot         , Wot         , Wot         , Wot         , Wot         , Wot         , Wot         , Wot         , Wot         , Wot         , Wot         
Wot         , Wot         , Wot         , Wot         , Wot         , Wot         , Wot         , Wot         , Wot         , Wot         , Wot         , Wwt         , Wwt         , Wwt         , Gs^Ft       , Wwt         , Gs          , Wwt         , Wwt         , Wwt         , Wwt         , Wot         , Wot         , Wwr         , Wwr         , Wot         , Wot         , Wot         , Wot         , Wot         , Wot         , Wot         , Wot         
Wot         , Wot         , Wot         , Wot         , Wot         , Wot         , Wot         , Wot         , Wot         , Wwr         , Wwr         , Wwt         , Dd          , Dd          , Gs^Ft       , Gs^Ft       , Gs^Ft       , Gs          , Ss          , Gs^Ft       , Gs          , Wwt         , Wwt         , Wwt         , Wwr         , Wot         , Wwr         , Wot         , Wot         , Wot         , Wot         , Wot         , Wot         
Wot         , Wot         , Wot         , Wot         , Wot         , Wot         , Wot         , Wot         , Wwr         , Wwr         , Wwt         , Wwt         , Dd          , Dd          , Gs^Ft       , Gs^Ft       , Rr^Vd       , Ss          , Ss          , Gs^Ft       , Ss          , Wwt         , Dd          , Wwt         , Wwt         , Wwt         , Wwr         , Wot         , Wot         , Wot         , Wot         , Wot         , Wot         
Wot         , Wot         , Wot         , Wot         , Wot         , Wot         , Wot         , Wwr         , Wwt         , Wwt         , Wwt         , Wwt         , Dd^Vdt      , Dd^Do       , Gs^Ft       , Ss          , Ss          , Ss          , Ss          , Ss          , Gs          , Gs^Ft       , Gs^Ft       , Dd          , Wwt         , Wwt         , Wwr         , Wwr         , Wot         , Wot         , Wot         , Wot         , Wot         
Wot         , Wot         , Wot         , Wot         , Wot         , Wot         , Wwr         , Wwr         , Wwt         , Wwt         , Gs          , Gs^Ft       , Gs          , Gs^Ft       , Ss          , Ss          , Ss          , Ss          , Gs^Ft       , Ss          , Rr^Vd       , Gs^Ft       , Gs^Ft       , Dd          , Wwt         , Wwt         , Wot         , Wot         , Wot         , Wot         , Wot         , Wot         , Wot         
Wot         , Wot         , Wot         , Wot         , Wot         , Wwr         , Wwt         , Wwt         , Wwt         , Wwt         , Ce          , Ss          , Ss          , Ss          , Gs^Ft       , Gs^Ft       , Gs^Ft       , Gs^Ft       , Gs^Ft       , Gs^Ft       , Gs          , Gs^Ft       , Gs^Ft       , Dd          , Dd          , Wwt         , Wot         , Wot         , Wot         , Wot         , Wot         , Wot         , Wot         
Wot         , Wot         , Wot         , Wot         , Wwr         , Wwt         , Wwt         , Wwt         , Wwt         , Wwt         , Wwt         , Ce          , Ss          , Ss          , Gs^Ft       , Gs^Ft       , Gs^Ft       , Gs^Ft       , Hh          , Gs          , Hh          , Gs          , Gs          , Gs          , Dd          , Wwt         , Wwt         , Wot         , Wot         , Wot         , Wot         , Wot         , Wot         
Wot         , Wot         , Wot         , Wot         , Wwt         , Wwt         , Wwt         , Wwt         , Ss          , Ce          , Ce          , 1 Ke        , Re          , Dd^Vdt      , Hh          , Rr^Vd       , Hh          , Hh          , Mm          , Hh          , Hh          , Ch          , 4 Kh        , Ch          , Gs          , Dd          , Wwt         , Wwt         , Wot         , Wot         , Wot         , Wot         , Wot         
Wot         , Wot         , Wot         , Wot         , Wwr         , Wwt         , Wwt         , Gs^Ft       , Gs^Ft       , Ss          , Ss          , Ss          , Re          , Hh          , Mm          , Hh          , Mm          , Mm          , Mm          , Mm          , Mm          , Hh          , Ch          , Gs          , Rr^Vd       , Gs          , Dd^Do       , Wwt         , Wwt         , Wot         , Wot         , Wot         , Wot         
Wot         , Wot         , Wot         , Wot         , Wwr         , Wwt         , Wwt         , Gs^Ft       , Gs^Ft       , Gs          , Re          , Gs          , Hh          , Mm          , Mm          , Mm          , Mm          , Mm          , Dd^Do       , Mm          , Mm          , Mm          , Mm          , Hh          , Hh          , Gs^Ft       , Gs^Ft       , Gs          , Gs^Ft       , Wwt         , Wot         , Wot         , Wot         
Wot         , Wot         , Wot         , Wot         , Wot         , Wwt         , Wwt         , Ss          , Ss          , Rr^Vd       , Gs          , Hh          , Hh          , Mm          , Hh          , Hh          , Hh          , Hh          , Gs^Ft       , Hh          , Hh          , Mm          , Mm          , Hh          , Hh          , Ss          , Ss          , Gs^Ft       , Gs^Ft       , Wwt         , Wot         , Wot         , Wot         
Wot         , Wot         , Wot         , Wot         , Wot         , Wwt         , Wwt         , Ss          , Gs          , Hh          , Re          , Hh          , Gs^Ft       , Hh          , Gs^Ft       , Hh          , Ss          , Gs^Ft       , Ss          , Rr^Vd       , Hh          , Hh          , Hh          , Mm          , Hh          , Ss          , Ss          , Gs^Ft       , Ss          , Wwt         , Wwt         , Wot         , Wot         
Wot         , Wot         , Wot         , Wot         , Wot         , Wot         , Wwt         , Gs^Ft       , Gs^Ft       , Gs          , Re          , Gs^Ft       , Gs^Ft       , Gs^Ft       , Wwt         , Ss          , Wwt         , Ss          , Ss          , Ss          , Ss          , Hh          , Gs^Ft       , Hh          , Hh          , Ss          , Ss          , Ss          , Gs^Ft       , Gs          , Wwt         , Wot         , Wot         
Wot         , Wot         , Wot         , Wot         , Wot         , Wot         , Wwt         , Gs^Ft       , Gs^Ft       , Dd^Vdt      , Ww^Bw|      , Wwt         , Wwt         , Wwt         , Wwt         , Wwt         , Wot         , Wwt         , Wwt         , Wwt         , Ss          , Ss          , Gs^Ft       , Hh          , Hh          , Ss          , Ss          , Rr^Vd       , Gs^Ft       , Gs          , Wwt         , Wot         , Wot         
Wot         , Wot         , Wot         , Wot         , Wot         , Wot         , Wot         , Wwt         , Wwt         , Wwt         , Ww^Bw|      , Wot         , Wot         , Wot         , Wot         , Wot         , Wot         , Wot         , Wot         , Wwt         , Wwt         , Ss          , Ss          , Hh          , Hh          , Ch          , Hh          , Ss          , Ss          , Gs^Ft       , Wwt         , Wot         , Wot         
Wot         , Wot         , Wot         , Wot         , Wot         , Wot         , Wot         , Wot         , Wot         , Wot         , Ww^Bw|      , Wwt         , Wwt         , Wwt         , Wwt         , Wot         , Wot         , Wot         , Wot         , Wwt         , Ss          , Ss          , Hh          , Hh          , Ch          , 3 Kh        , Ch          , Gg          , Dd          , Wwt         , Wwt         , Wot         , Wot         
Wot         , Wot         , Wot         , Wot         , Wot         , Wot         , Wwt         , Wwt         , Wwt         , Wwt         , Re          , Gs^Ft       , Gs^Ft       , Ss          , Wwt         , Wot         , Wwt         , Wot         , Wwt         , Wwt         , Ss          , Ss          , Rr^Vd       , Hh          , Hh          , Hh          , Gg          , Gg          , Dd          , Wwt         , Wwt         , Wot         , Wot         
Wot         , Wot         , Wot         , Wot         , Wot         , Wwt         , Gs^Ft       , Gs          , Rr^Vd       , Ss          , Re          , Gs^Ft       , Rr^Vd       , Ss          , Ss          , Wwt         , Ss          , Wwt         , Ss          , Ss          , Hh          , Hh          , Mm          , Hh          , Hh          , Hh          , Dd^Vda      , Dd          , Wwt         , Wwt         , Wot         , Wot         , Wot         
Wot         , Wot         , Wot         , Wot         , Wot         , Wwt         , Gs^Ft       , Hh          , Hh          , Ss          , Re          , Hh          , Hh          , Gs^Ft       , Hh          , Ss          , Hh          , Ss          , Hh          , Ss          , Mm          , Hh          , Mm          , Mm          , Hh          , Ss          , Ss          , Wwt         , Wwt         , Wwt         , Wot         , Wot         , Wot         
Wot         , Wot         , Wot         , Wot         , Wot         , Wwt         , Wwt         , Gs          , Hh          , Hh          , Gs          , Hh          , Hh          , Ch          , Hh          , Rr^Vd       , Mm          , Hh          , Mm          , Mm          , Mm          , Mm          , Hh          , Hh          , Gs^Ft       , Gs^Ft       , Gs          , Wwt         , Wwt         , Wot         , Wot         , Wot         , Wot         
Wot         , Wot         , Wot         , Wot         , Wot         , Wwt         , Wwt         , Gs          , Ss          , Ss          , Gs^Ft       , Gs          , Ch          , 2 Kh        , Ch          , Mm          , Mm          , Mm          , Mm          , Mm          , Mm          , Hh          , Hh          , Hh          , Gs^Ft       , Gs^Ft       , Gs^Ft       , Wwt         , Wwt         , Wot         , Wot         , Wot         , Wot         
Wot         , Wot         , Wot         , Wot         , Wot         , Wot         , Wwt         , Wwt         , Gs          , Ss          , Gs^Ft       , Gs^Ft       , Gs^Ft       , Gs^Ft       , Gs^Ft       , Hh          , Hh          , Hh          , Hh          , Hh          , Hh          , Hh          , Rr^Vd       , Gs          , Gs          , Gs^Ft       , Dd          , Wwt         , Wwt         , Wwr         , Wwr         , Wot         , Wot         
Wot         , Wot         , Wot         , Wot         , Wot         , Wot         , Wot         , Wwt         , Wwt         , Gs^Ft       , Dd          , Dd^Do       , Dd          , Gs^Ft       , Gs          , Ss          , Ss          , Ss          , Ss          , Hh          , Gs^Ft       , Hh          , Gs^Ft       , Gs          , Dd          , Dd          , Wwt         , Wwt         , Wwr         , Wwt         , Wot         , Wot         , Wot         
Wot         , Wot         , Wot         , Wot         , Wot         , Wot         , Wot         , Wwt         , Wwt         , Wwt         , Wwt         , Dd          , Wwt         , Dd          , Dd^Vda      , Ss          , Ss          , Gs          , Gs          , Gs^Ft       , Gs^Ft       , Gs^Ft       , Gs^Ft       , Gs          , Dd          , Wwt         , Wwt         , Wwt         , Wwt         , Wot         , Wot         , Wot         , Wot         
Wot         , Wot         , Wot         , Wot         , Wot         , Wot         , Wot         , Wot         , Wot         , Wwt         , Wwt         , Wwt         , Wwt         , Wwt         , Wwt         , Wwt         , Gs          , Ss          , Gs          , Gs          , Gs^Ft       , Gs^Ft       , Gs^Ft       , Gs^Ft       , Wwt         , Wwt         , Wwt         , Wwt         , Wwt         , Wwr         , Wot         , Wot         , Wot         
Wot         , Wot         , Wot         , Wot         , Wot         , Wot         , Wot         , Wot         , Wot         , Wot         , Wot         , Wot         , Wot         , Wwt         , Wwt         , Wwt         , Wwt         , Gs          , Dd          , Dd^Vdt      , Dd          , Gs          , Wwt         , Wwt         , Wwt         , Wwt         , Wwr         , Wwr         , Wot         , Wot         , Wot         , Wot         , Wot         
Wot         , Wot         , Wot         , Wot         , Wot         , Wot         , Wot         , Wot         , Wot         , Wot         , Wot         , Wot         , Wot         , Wot         , Wot         , Wwt         , Wwt         , Wwt         , Wwt         , Dd          , Wwt         , Wwt         , Wwt         , Wwt         , Wwr         , Wwt         , Wwr         , Wot         , Wot         , Wot         , Wot         , Wot         , Wot         
Wot         , Wot         , Wot         , Wot         , Wot         , Wot         , Wot         , Wot         , Wot         , Wot         , Wot         , Wot         , Wot         , Wot         , Wot         , Wot         , Wot         , Wwt         , Wot         , Wwt         , Wot         , Wwt         , Wot         , Wwr         , Wot         , Wot         , Wot         , Wot         , Wot         , Wot         , Wot         , Wot         , Wot         
Wot         , Wot         , Wot         , Wot         , Wot         , Wot         , Wot         , Wot         , Wot         , Wot         , Wot         , Wot         , Wot         , Wot         , Wot         , Wot         , Wot         , Wot         , Wot         , Wot         , Wot         , Wot         , Wot         , Wot         , Wot         , Wot         , Wot         , Wot         , Wot         , Wot         , Wot         , Wot         , Wot         
