border_size=1
usage=map

Wot         , Wot         , Wot         , Wot         , Wot         , Wot         , Wot         , Wot         , Wot         , Wot         , Wot         , Wot         , Wot         , Wot         , Wot         , Wot         , Wot         , Wot         , Wot         , Wot         , Wot         , Wot         , Wot         , Wot         , Wot         , Wot         , Wot         , Wot         , Wot         , Wot         , Wot         , Wot         , Wot         , Wot         , Wot         
Wot         , Wot         , Wot         , Wot         , Wot         , Wot         , Wot         , Wot         , Wot         , Wot         , Wot         , Wot         , Wot         , Wot         , Wot         , Wot         , Wot         , Wot         , Wot         , Wot         , Wot         , Wot         , Wot         , Wot         , Wot         , Wot         , Wot         , Wot         , Wot         , Wot         , Wot         , Wot         , Wot         , Wot         , Wot         
Wot         , Wot         , Wot         , Wot         , Wwt         , Wwr         , Wwr         , Wot         , Wot         , Wot         , Wot         , Wot         , Wot         , Wot         , Wot         , Wwr         , Wwr         , Wwr         , Wwr         , Wot         , Wot         , Wot         , Wot         , Wot         , Wot         , Wot         , Wot         , Wot         , Wwt         , Wwt         , Wwt         , Wwt         , Wwt         , Wot         , Wot         
Wot         , Wot         , Wwt         , Wwt         , Wwt         , Wwr         , Wwt         , Wwt         , Wwt         , Wot         , Wwt         , Wwt         , Wwt         , Wwt         , Wwt         , Wwt         , Wwt         , Wwt         , Wwr         , Wwr         , Wot         , Wot         , Wot         , Wot         , Wot         , Wot         , Wwt         , Wwt         , Wwt         , Gs          , Gs^Fds      , Gs^Fds      , Wwt         , Wot         , Wot         
Wot         , Wot         , Wwt         , Wwr         , Wwr         , Dd          , Wwt         , Wwt         , Wwt         , Wwt         , Wwt         , Hd          , Hd          , Hd          , Wwt         , Hd          , Wwt         , Wwt         , Wwt         , Wwr         , Wot         , Wot         , Wot         , Wot         , Wot         , Wot         , Wot         , Wwt         , Gg^Vc       , Ss          , Ss          , Gs^Fds      , Wwt         , Wot         , Wot         
Wot         , Wot         , Wwt         , Wwr         , Dd          , Dd^Vda      , Dd          , Dd          , Dd          , Dd          , Dd          , Hd          , Hd          , Md          , Md          , Md          , Hd          , Wwt         , Wwt         , Wot         , Wwr         , Wot         , Wot         , Wot         , Wot         , Wot         , Wot         , Wwt         , Gs          , Gs          , Ss          , Gs^Fds      , Wwt         , Wot         , Wot         
Wot         , Wot         , Wwt         , Gs^Ft       , Dd          , Gs^Ft       , Dd          , Chr         , Chr         , Chr         , Dd          , Wwt         , Dd^Vda      , Hd          , Md          , Hd          , Hd          , Gs^Ft       , Wwt         , Wwt         , Wwt         , Wwt         , Wwt         , Wot         , Wot         , Wot         , Wot         , Wwt         , Wwt         , Wwt         , Gs^Fds      , Wwt         , Wot         , Wot         , Wot         
Wot         , Wot         , Wot         , Wwt         , Gs^Ft       , Gs^Ft       , Gs^Ft       , Chr         , 3 Khr       , Chr         , Dd          , Dd          , Hd          , Md          , Md          , Md          , Hd          , Gs^Ft       , Gs^Fds      , Gs^Fds      , Gg^Vc       , Wwt         , Wwt         , Wwt         , Wot         , Wot         , Wot         , Wot         , Wwt         , Wwt         , Wwt         , Wwt         , Wot         , Wot         , Wot         
Wot         , Wot         , Wot         , Wwt         , Wwt         , Wwt         , Gs^Ft       , Dd          , Dd          , Dd          , Hd          , Gs^Ft       , Md          , Md          , Md          , Hd          , Gs^Ft       , Gs^Ft       , Gs^Fds      , Gs^Fds      , Gs^Fds      , Gs^Fds      , Wwt         , Wwt         , Wwt         , Wot         , Wot         , Wwt         , Ww^Bw\      , Wwt         , Wwt         , Wot         , Wot         , Wot         , Wot         
Wot         , Wot         , Wot         , Wot         , Wwt         , Wwt         , Gs^Ft       , Gs^Ft       , Dd^Do       , Dd          , Md          , Hd          , Md          , Md          , Md          , Hd          , Gs^Ft       , Dd          , Gs^Fds      , Gs^Fds      , Gs^Fds      , Gs^Fds      , Gs^Fds      , Gs^Fds      , Wwt         , Wot         , Wwt         , Wwt         , Gs          , Gg^Vc       , Wwt         , Wwt         , Wot         , Wot         , Wot         
Wot         , Wot         , Wot         , Wot         , Wwt         , Wwt         , Wwt         , Wwt         , Gs^Ft       , Hd          , Gs^Ft       , Hd          , Md          , Hd          , Hd          , Hd          , Dd          , Dd          , Dd          , Gs^Fds      , Gs^Ft       , Gs^Fds      , Gs^Fds      , Gs^Fds      , Wwt         , Wwt         , Wwt         , Wwt         , Gs          , Gs          , Gs^Fds      , Wwt         , Wwt         , Wot         , Wot         
Wot         , Wot         , Wot         , Wot         , Wwt         , Wwt         , Wwt         , Wwt         , Gs^Ft       , Gs^Ft       , Dd          , Hd          , Hd          , Gs^Vht      , Gs^Ft       , Hd          , Dd          , Dd          , Dd          , Gs^Fds      , Gs^Ft       , Ss          , Gs^Fds      , Gs^Ft       , Gs          , Dd          , Wwt         , Wwt         , Co          , Co          , Gs^Fds      , Dd          , Wwt         , Wot         , Wot         
Wot         , Wot         , Wot         , Wot         , Wot         , Wot         , Wwr         , Wwt         , Dd          , Dd          , Gs^Ft       , Dd          , Gs^Ft       , Gs^Ft       , Gs^Ft       , Dd          , Gs^Ft       , Dd          , Gs^Ft       , Gs^Fds      , Gs^Fds      , Gs^Fds      , Gs^Fds      , Gs^Fds      , Gg^Vc       , Wwt         , Wwt         , Wwt         , Wwt         , 2 Ko        , Co          , Dd          , Wwt         , Wot         , Wot         
Wot         , Wot         , Wot         , Wot         , Wot         , Wot         , Wwr         , Wwr         , Dd          , Gs^Ft       , Gs^Fds      , Re          , Gs^Ft       , Ss          , Ss          , Gs^Fds      , Gs^Ft       , Gs^Fds      , Re          , Re          , Gs^Fds      , Gs^Fds      , Gs^Fds      , Gs^Fds      , Gs          , Gs          , Wwt         , Wwt         , Wwt         , Co          , Wwt         , Dd          , Wwt         , Wot         , Wot         
Wot         , Wot         , Wot         , Wot         , Wwt         , Wwr         , Wwr         , Dd          , Dd          , Gs^Ft       , Gs^Fds      , Re          , Re          , Gs^Fds      , Re          , Re          , Gs^Fds      , Gs^Ft       , Gs^Fds      , Re          , Gs^Ft       , Gs^Fds      , Gs^Ft       , Gs^Vht      , Gs^Fds      , Gs^Fds      , Gs          , Wwt         , Wwt         , Wwt         , Dd          , Wwt         , Wot         , Wot         , Wot         
Wot         , Wot         , Wot         , Wwt         , Wwt         , Gs          , Gs          , Gs^Ft       , Gs^Ft       , Re          , Re          , Gs^Fds      , Gs^Ft       , Gs^Fds      , Gs^Fds      , Gs^Fds      , Gs^Fds      , Gs^Fds      , Gs^Fds      , Re          , Re          , Re          , Gs^Ft       , Gg          , Gs^Fds      , Gs^Fds      , Gs          , Gs          , Gg^Vc       , Gs^Ft       , Wwt         , Wwt         , Wot         , Wot         , Wot         
Wot         , Wot         , Wwt         , Wwt         , Wwt         , Gs          , Gs^Fds      , Gs^Vht      , Gs^Fds      , Re          , Gs^Fds      , Gs^Ft       , Gs^Ft       , Ss          , Gs^Fds      , Gs^Fds      , Gs^Fds      , Re          , Re          , Gs^Fds      , Gs^Fds      , Gs^Ft       , Ss          , Ss          , Gs^Fds      , Re          , Gs^Fds      , Gs^Fds      , Gs^Fds      , Gs^Fds      , Gs^Fds      , Wwt         , Wot         , Wot         , Wot         
Wot         , Wot         , Wwt         , Gs          , Wwt         , Gs          , Gs^Fds      , Gs^Fds      , Gs^Fds      , Gs^Fds      , Re          , Re          , Gs          , Gs^Ft       , Gs^Fds      , Gs^Fds      , Gs^Ft       , Re          , Gs^Vht      , Gs^Fds      , Gs^Fds      , Gs^Fds      , Gs^Fds      , Gs^Ft       , Re          , Gs^Fds      , Re          , Re          , Re          , Gs^Fds      , Gs^Ft       , Wwt         , Wot         , Wot         , Wot         
Wot         , Wot         , Wwt         , Gs^Ft       , Wwt         , Wwt         , Gs          , Gs          , Gs^Ft       , Gs^Ft       , Gs^Ft       , Re          , Gs          , Gs          , Gs^Ft       , Gs          , Ss          , Re          , Gs^Fds      , Gs^Fds      , Gs^Fds      , Gs^Fds      , Gs^Fds      , Gs^Fds      , Re          , Gs^Ft       , Gs^Ft       , Re          , Gg^Vc       , Gs^Ft       , Wwt         , Wwt         , Wot         , Wot         , Wot         
Wot         , Wot         , Wwt         , Gs^Ft       , Gs^Ft       , Wwt         , Wwt         , Wwt         , Wwt         , Wwt         , Gs^Ft       , Dd          , Gs          , Gs          , Gs          , Gs          , Gs          , Re          , Gs^Fds      , Gs^Fds      , Gs^Fds      , Gs^Fds      , Gs^Fds      , Gs^Fds      , Re          , Re          , Re          , Gs^Ft       , Gs^Ft       , Wwt         , Wwt         , Wot         , Wot         , Wot         , Wot         
Wot         , Wot         , Wwt         , Gs^Ft       , Gs          , Wwt         , Wot         , Wot         , Wwt         , Wwt         , Dd          , Dd          , Dd          , Dd          , Gs          , Dd          , Gs          , Re          , Gs          , Gs          , Gs          , Gs          , Gs^Fds      , Gs          , Gs^Ft       , Gs^Ft       , Gs^Ft       , Wwt         , Wwt         , Wwt         , Wot         , Wot         , Wot         , Wot         , Wot         
Wot         , Wot         , Wot         , Wwt         , Wwt         , Wwt         , Wot         , Wot         , Wwr         , Wwt         , Wwt         , Wwt         , Dd          , Dd          , Dd          , Dd          , Dd          , Dd          , Gs          , Dd          , Dd          , Wwt         , Gs          , Wwt         , Gs          , Wwt         , Wwt         , Wwt         , Wwt         , Wot         , Wot         , Wot         , Wot         , Wot         , Wot         
Wot         , Wot         , Wot         , Wot         , Wwt         , Wot         , Wwt         , Wwr         , Wwr         , Wwt         , Dd          , Dd          , Ss          , Dd          , Ss          , Ss          , Dd          , Dd          , Dd          , Dd          , Dd          , Wwt         , Wwt         , Wwt         , Wwt         , Wwt         , Wwt         , Wwt         , Wwt         , Wwt         , Wwt         , Wot         , Wwt         , Wot         , Wot         
Wot         , Wot         , Wot         , Wwt         , Wwt         , Wwt         , Wwt         , Wwt         , Wwt         , Wwt         , Wwt         , Dd          , Dd          , Dd          , Dd          , Ss          , Dd          , Dd          , Dd          , Wwt         , Wwt         , Wwt         , Wot         , Wot         , Wot         , Wwt         , Wwt         , Wwt         , Wwt         , Dd          , Wwt         , Wwt         , Wwt         , Wot         , Wot         
Wot         , Wot         , Wot         , Wwt         , Gs          , Gs          , Gs          , Gs          , Dd          , Wwt         , Wwt         , Wwt         , Ss          , Ss          , Dd          , Ss          , Dd          , Wwt         , Wwt         , Wwt         , Wwr         , Wot         , Wot         , Wot         , Wot         , Wwt         , Wwt         , Dd          , Dd          , Dd          , Dd          , Dd          , Wwt         , Wot         , Wot         
Wot         , Wot         , Wwt         , Wwt         , Gg^Vc       , Gs^Ft       , Gs^Ft       , Gs^Ft       , Dd          , Dd          , Ss          , Ss          , Dd          , Dd          , Dd          , Dd          , Wwt         , Wwt         , Wwr         , Wwt         , Wwr         , Wwr         , Wot         , Wot         , Wwt         , Wwt         , Dd          , Gs          , Gs^Ft       , Gs^Vht      , Gs^Ft       , Dd          , Wwt         , Wot         , Wot         
Wot         , Wot         , Wwt         , Wwt         , Gs          , Gs^Ft       , Gs^Ft       , Gs^Ft       , Dd          , Ss          , Ww          , Ss          , Ww          , Ww          , Dd          , Dd          , Wwt         , Wwr         , Wwr         , Wot         , Wot         , Wot         , Wot         , Wot         , Wwt         , Wwt         , Dd          , Gs          , Gs          , Gs^Ft       , Gs^Ft       , Dd          , Wwt         , Wot         , Wot         
Wot         , Wot         , Wwt         , Gs^Ft       , Gs^Ft       , Gs^Ft       , Gs^Ft       , Dd^Vda      , Dd          , Dd          , Ss          , Ss          , Ww          , Ss          , Wwt         , Wwt         , Wwr         , Wwt         , Wot         , Wot         , Wot         , Wot         , Wot         , Wot         , Wot         , Wwt         , Wwr         , Wwr         , Dd          , Dd          , Dd          , Wwt         , Wot         , Wot         , Wot         
Wot         , Wot         , Wwt         , Gs^Ft       , Gs^Vht      , Gs^Ft       , Gs^Ft       , Gs^Ft       , Dd          , Dd          , Dd          , Dd          , Dd          , Ss          , Dd          , Wwt         , Wot         , Wot         , Wot         , Wot         , Wot         , Wot         , Wot         , Wot         , Wwt         , Wwt         , Wwt         , Wwr         , Wwr         , Wwt         , Wwt         , Wwt         , Wot         , Wot         , Wot         
Wot         , Wot         , Wwt         , Wwt         , Ce          , Gs^Ft       , Gs          , Ss          , Gs          , Gs          , Dd          , Ss          , Dd          , Dd          , Gs          , Wwt         , Wot         , Wot         , Wot         , Wot         , Wot         , Wot         , Wot         , Wot         , Wwt         , Wwt         , Wwt         , Wwr         , Wwt         , Wwt         , Wwt         , Wwt         , Wot         , Wot         , Wot         
Wot         , Wot         , Wot         , Ce          , Ce          , Gs          , Gs^Ft       , Gs          , Ss          , Gs^Ft       , Gs          , Dd          , Dd^Vda      , Gs          , Gs          , Wwt         , Wwt         , Wwt         , Wot         , Wot         , Wot         , Wot         , Wot         , Wwt         , Wwt         , Dd^Vda      , Wwr         , Wwr         , Wwt         , Wwt         , Wot         , Wot         , Wot         , Wot         , Wot         
Wot         , Wot         , Wwt         , 1 Ke        , Ce          , Ce          , Gs^Ft       , Gs^Ft       , Ss          , Ss          , Gs^Ft       , Gs          , Gs          , Gs          , Gs^Fds      , Gs          , Wwt         , Wwt         , Wot         , Wot         , Wot         , Wot         , Wwt         , Wwt         , Dd          , Dd          , Dd          , Dd          , Wwt         , Wot         , Wot         , Wot         , Wot         , Wot         , Wot         
Wot         , Wot         , Wwt         , Gs^Ft       , Gs          , Gs^Ft       , Gs^Ft       , Gs          , Gs^Ft       , Gs          , Gs          , Gs          , Gs          , Gs^Fds      , Gs^Fds      , Wwt         , Wwt         , Wot         , Wot         , Wot         , Wot         , Wwt         , Wwt         , Ww^Bw\      , Dd          , Hd          , Hd          , Md          , Wwt         , Wwt         , Wwt         , Wwt         , Wwt         , Wot         , Wot         
Wot         , Wot         , Wwt         , Dd^Do       , Dd          , Gs          , Gs          , Gs          , Gs          , Gs          , Gs          , Gs          , Gs^Fds      , Gs^Fds      , Wwt         , Wwt         , Wot         , Wot         , Wot         , Wwt         , Wwt         , Wwt         , Wwt         , Dd          , Gs^Ft       , Md          , Md          , Md          , Dd          , Dd          , Wwt         , Wwt         , Wwt         , Wot         , Wot         
Wot         , Wot         , Wwt         , Dd          , Gs          , Gs          , Gs          , Gs          , Ss          , Gs          , Gs          , Gs^Vht      , Gs          , Wwt         , Wwt         , Wot         , Wot         , Wot         , Wot         , Wwt         , Wwt         , Gs          , Gs          , Gs^Ft       , Hd          , Md          , Hd          , Hd          , Chr         , Dd          , Dd^Vda      , Wwt         , Wwt         , Wot         , Wot         
Wot         , Wot         , Wwt         , Dd          , Gs          , Gs          , Gs          , Ss          , Gs          , Gs          , Gs          , Gs          , Gs          , Wwt         , Wwt         , Wot         , Wot         , Wot         , Wot         , Wot         , Wwt         , Wwt         , Gs          , Hd          , Md          , Md          , Hd          , Chr         , 4 Khr       , Wwr         , Wwt         , Wwt         , Wot         , Wot         , Wot         
Wot         , Wot         , Wwt         , Wwt         , Wwr         , Wwr         , Gs          , Gs          , Gs          , Gs          , Gs          , Gs          , Wwr         , Wwt         , Wot         , Wot         , Wot         , Wot         , Wwr         , Wot         , Wot         , Wwt         , Wwt         , Gs          , Gs          , Gs^Vht      , Gs          , Chr         , Wwr         , Wwr         , Wot         , Wot         , Wot         , Wot         , Wot         
Wot         , Wot         , Wot         , Wwt         , Wwt         , Wwr         , Gs          , Gs^Vht      , Gs          , Gs          , Gs          , Gs          , Wwr         , Wwt         , Wot         , Wwr         , Wwr         , Wwr         , Wwr         , Wwr         , Wwr         , Wot         , Wwt         , Wwt         , Gs          , Ss          , Gs          , Wwr         , Wwr         , Wwr         , Wwr         , Wot         , Wot         , Wot         , Wot         
Wot         , Wot         , Wot         , Wot         , Wwt         , Wwr         , Wwr         , Gs          , Wwt         , Gs          , Wwr         , Wwr         , Wwr         , Wwt         , Wwr         , Wwr         , Wot         , Wot         , Wot         , Wot         , Wot         , Wot         , Wwt         , Wwt         , Gs          , Wwt         , Wwt         , Wwt         , Wot         , Wot         , Wot         , Wot         , Wot         , Wot         , Wot         
Wot         , Wot         , Wot         , Wot         , Wot         , Wwt         , Wwt         , Wwt         , Wwt         , Wwt         , Wwt         , Wwr         , Wwt         , Wwr         , Wwr         , Wwr         , Wot         , Wot         , Wot         , Wot         , Wot         , Wot         , Wwt         , Wwt         , Wwt         , Wwt         , Wwt         , Wot         , Wot         , Wot         , Wot         , Wot         , Wot         , Wot         , Wot         
Wot         , Wot         , Wot         , Wot         , Wot         , Wot         , Wot         , Wwt         , Wot         , Wwt         , Wot         , Wot         , Wot         , Wwr         , Wot         , Wot         , Wot         , Wot         , Wot         , Wot         , Wot         , Wot         , Wot         , Wwt         , Wot         , Wwt         , Wot         , Wot         , Wot         , Wot         , Wot         , Wot         , Wot         , Wot         , Wot         
Wot         , Wot         , Wot         , Wot         , Wot         , Wot         , Wot         , Wot         , Wot         , Wot         , Wot         , Wot         , Wot         , Wot         , Wot         , Wot         , Wot         , Wot         , Wot         , Wot         , Wot         , Wot         , Wot         , Wot         , Wot         , Wot         , Wot         , Wot         , Wot         , Wot         , Wot         , Wot         , Wot         , Wot         , Wot         
