Ww, Gll^Fdf, Gll^Fdf, Gll^Fdf, Gll^Fdf, Gll^Fdf, Gll^Fdf, Gll^Fdf, Gll^Fdf, Ww, Ww, Ww, Ww, Ww, Ww, Ww, Ww, Ww, Ww, Ww, Ss, Ss, Gll^Fdf, Gll^Fdf, Gll^Fdf, Gll^Fdf, Gll^Fdf, Gll^Fdf, Gll^Fdf, Gll^Fmf, Gll^Fmf, Gll^Fdf, Gll^Fmf, Gll^Fmf, Gll^Fdf, Gll^Fdf, Gll^Fdf, Gll^Fdf, Gll^Fdf, Gll^Fdf, Gll^Fdf, Gll^Fdf, Gll^Fdf, Gll^Fdf, Gll^Fdf, Gll^Fdf
Wo, Ww, Ww, Gll^Fdf, Gll^Fdf, Gll^Fdf, Ss, Ss, Gll^Fdf, Ss, Ss, Ww, Ww, Ww, Ww, Ww, Ss, Ss, Ss, Ss, Ss, Ss, Gll^Fdf, Gll^Fdf, Gll^Fdf, Gll^Fdf, Gll^Fdf, Gll^Fdf, Gll^Fdf, Gll^Fdf, Gll^Fdf, Gll^Fmf, Gll^Fmf, Gll^Fdf, Gll^Fdf, Gll^Fdf, Gll^Fdf, Gll^Fdf, Gll^Fdf, Gll^Fdf, Gll^Fdf, Gll^Fdf, Gll^Fdf, Gll^Fdf, Gll^Fdf, Gll^Fdf
Ww, Wo, Wo, Ww, Gll^Fmf, Gll^Fdf, Ss, Gll^Fdf, Gll^Fdf, Gll^Fdf, Ss, Ww, Ss, Ww, Ss, Ss, Gll^Fmf, Gll^Fdf, Gll^Fdf, Gll^Fdf, Gll^Fdf, Gll^Fdf, Gll^Fdf, Gll^Fdf, Gll^Fdf, Gll^Fdf, Gll^Fdf, Gll^Fdf, Gll^Fdf, Gll^Fdf, Gll^Fdf, Gll^Fmf, Gll^Fdf, Gll^Fdf, Gll^Fdf, Gll^Fdf, Gll^Fmf, Gll^Fmf, Gg^Ve, Gll^Fmf, Gll^Fmf, Gll^Fmf, Gg^Fdf, Gll^Fmf, Gll^Fmf, Gg^Fdf
Gll^Fmf, Ww, Ww, Ww, Ww, Gll^Fdf, Gll^Fdf, Ss, Ss, Gll^Fdf, Ss, Ss, Gll^Fdf, Ss, Gll^Fmf, Ss, Gll^Fmf, Gll^Fdf, Gll^Fdf, Gll^Fdf, Gll^Fdf, Gll^Fdf, Gll^Fdf, Gll^Fdf, Gll^Fdf, Gll^Fdf, Gll^Fdf, Gll^Fdf, Gll^Fdf, Gll^Fdf, Gll^Fdf, Gll^Fdf, Gll^Fdf, Gll^Fdf, Gll^Fdf, Gll^Fmf, Gll^Fdf, Gll^Fdf, Gll^Fdf, Gll^Fmf, Gll^Fdf, Gll^Fdf, Gll^Fmf, Gg^Fdf, Gll^Fmf, Gll^Fmf
Gll^Fmf, Ww, Ww, Wo, Ww, Gll^Fdf, Gll^Fdf, Gll^Fdf, Gll^Fdf, Ss, Ss, Ss, Gll^Fdf, Ss, Ss, Gll^Fdf, Gll^Fdf, Gll^Fdf, Gll^Fdf, Gll^Fdf, Gg^Eff, Gg^Eff, Gg^Edb, Gg^Eff, Gg^Eff, Gll^Fdf, Gll^Fdf, Gll^Fdf, Gll^Fdf, Gll^Fmf, Gll^Fmf, Gll^Fdf, Gll^Fdf, Gll^Fdf, Gll^Fdf, Gll^Fmf, Gll^Fmf, Gll^Fdf, Gll^Fdf, Gll^Fmf, Gll^Fmf, Gll^Fdf, Gll^Fmf, Gll^Fmf, Gll^Fmf, Gll^Fmf
Gll^Fmf, Gll^Fmf, Ww, Wo, Wo, Ww, Gll^Fp, Gll^Fdf, Ss, Ss, Ss, Ss, Gll^Fdf, Gll^Fdf, Gll^Fdf, Gll^Fdf, Gll^Fdf, Gll^Fdf, Gll^Fdf, Gll^Fdf, Gll^Fdf, Gg^Edb, Gll^Cov, Gg^Edb, Gll^Fdf, Gll^Fdf, Gll^Fdf, Gll^Fdf, Gll^Fdf, Gll^Fdf, Gll^Fmf, Gll^Fmf, Gll^Fmf, Gll^Fdf, Gll^Fdf, Gg^Fet, Gll^Fdf, Gll^Fmf, Cv, Gll^Fdf, Gll^Fmf, Gll^Fdf, Gll^Fdf, Gll^Fmf, Gll^Fdf, Gll^Fmf
Gll^Fmf, Gll^Fmf, Ww, Ww, Wo, Ww, Gll^Fmf, Gll^Fmf, Gll^Fdf, Ss, Ss, Ss, Gll^Fdf, Gll^Fdf, Gll^Fdf, Gll^Fdf, Gll^Fdf, Gll^Fdf, Gg^Eff, Gg^Eff, Gll^Cov, 3 Gll^Kov, Gg^Edb, Gll^Fdf, Gll^Fdf, Gll^Fdf, Gll^Fdf, Gll^Fdf, Gll^Fdf, Gll^Fdf, Gll^Fdf, Gll^Fdf, Gll^Fdf, Gll^Fdf, Gll^Fdf, Gll^Fmf, Gll^Fdf, Cv, Gll^Fmf, Gll^Fdf, Gg^Fet, Gll^Fmf, Gll^Fmf, Gll^Fmf, Gll^Fdf, Gll^Fdf
Gll^Fmf, Gll^Fmf, Gll^Fmf, Ww, Wo, Ww, Gll^Fmf, Gll^Fdf, Gll^Fdf, Ss, Ss, Ss, Ss, Gll^Fmf, Gll^Fmf, Gll^Fmf, Gll^Fdf, Gll^Fdf, Gg^Eff, Gg^Edb, Gg^Edb, Gg^Edb, Gg^Eff, Gg^Eff, Gg^Em, Gll^Fdf, Gll^Fdf, Gll^Fdf, Gll^Fdf, Gll^Fdf, Gll^Fmf, Gg^Ve, Gll^Fdf, Gll^Fmf, Gll^Fdf, Cv, Cv, 4 Kv, Cv, Gll^Fdf, Gll^Fdf, Gll^Fdf, Gg^Ve, Gll^Fdf, Gll^Fdf, Gll^Fdf
Gll^Fmf, Gll^Fmf, Gll^Fmf, Ww, Wo, Ww, Ww, Gll^Fmf, Gll^Fdf, Ss, Ss, Ss, Ss, Ss, Ss, Gll^Fmf, Gll^Fdf, Gll^Fdf, Gll^Fdf, Gg^Eff, Gll^Fdf, Gll^Fdf, Gll^Fdf, Gll^Fdf, Gll^Fdf, Gg^Em, Gll, Gll^Fdf, Gll^Fdf, Gll^Fdf, Gll^Fdf, Gll^Fmf, Gll^Fdf, Gll^Fdf, Gll^Fdf, Gll^Fdf, Gll^Fdf, Gll^Fmf, Cv, Gll^Fdf, Gg^Fdf, Gll^Fmf, Gll^Fdf, Gll^Fmf, Gll^Fmf, Gll^Fdf
Ss, Ss, Gll^Fmf, Ww, Ww, Wo, Ww, Gll^Fdf, Gll^Fdf, Gg^Fmf, Ss, Gll^Fdf, Ss, Ss, Ss, Ss, Gll^Fdf, Gll^Fdf, Gll^Fdf, Gll^Fdf, Gll^Fdf, Gll^Fdf, Gll^Fdf, Gll^Fdf, Gll^Fdf, Gll^Fdf, Gll^Fdf, Gll, Gll^Fdf, Gll^Fdf, Gll^Fdf, Gll^Fdf, Gll^Fdf, Gll^Fdf, Gll^Fdf, Gll^Fdf, Gg^Fet, Gll^Fmf, Gll^Fdf, Gll^Fmf, Gll^Fdf, Gll^Fdf, Gll^Fdf, Gll^Fmf, Gll^Fdf, Gll^Fdf
Ss, Ss, Gll^Fmf, Gll^Fdf, Ww, Wo, Ww, Gll^Fp, Gll^Fdf, Gg^Fmf, Gll^Fdf, Ss, Ss, Ss, Ss^Fdf, Ss, Ss, Gll^Fdf, Ss, Gll^Fdf, Gll^Fdf, Gll^Fdf, Gll^Fdf, Gll^Fdf, Gll^Fdf, Gll^Fdf, Gll^Fdf, Gg^Em, Gg^Em, Gll^Fdf, Gll^Fdf, Gll^Fdf, Gll^Fdf, Gll^Fdf, Gll^Fdf, Gll^Fdf, Gll^Fdf, Gll^Fdf, Gll^Fdf, Gll^Fdf, Gs^Fdf, Gll^Fdf, Gll^Fdf, Gll^Fdf, Gll^Fdf, Gll^Fdf
Ss, Gll^Fmf, Gll^Fmf, Gll^Fdf, Ww, Ww, Ww, Gll^Fp, Gll^Fdf, Gll^Fdf, Gg^Fmf, Ss, Ss, Ss, Gll^Fdf, Ss, Gll^Fdf, Ss, Ss, Gll^Fdf, Ss, Gg^Fmf, Ss, Gll^Fdf, Gg^Fmf, Gll^Fdf, Gll^Fdf, Gll^Fdf, Gll^Fdf, Gg^Em, Gll^Fdf, Gll^Fdf, Gll^Fdf, Gll^Fdf, Gll^Fdf, Gll^Fdf, Gll^Fdf, Gll^Fdf, Gg^Em, Gg^Em, Gg^Em, Gg^Em, Gg^Em, Gll^Fdf, Gll^Fdf, Gll^Fdf
Gll^Fmf, Ss, Gll^Fdf, Gll^Fp, Ww, Wo, Ww, Gll^Fdf, Gll^Fdf, Gll^Fdf, Gll^Fdf, Ss, Ss, Ss, Gll^Fdf, Gll^Fdf, Gll^Fdf, Gll^Fdf, Gll^Fdf, Ss, Gll^Fdf, Ss, Ss, Ss, Gll^Fdf, Gll^Fdf, Gll^Fdf, Gll^Fdf, Gll^Fdf, Gll, Gg^Em, Gll^Fdf, Gll^Fdf, Gll^Fdf, Gll^Fdf, Gll^Fdf, Gll^Fdf, Gll^Fdf, Gg^Em, Gg^Em, Gg^Fetd, Gg^Efm, Gg^Em, Gll^Fdf, Gll^Fdf, Gll^Fdf
Gll^Fmf, Gll^Fmf, Gll^Fdf, Gll^Fdf, Ww, Wo, Wo, Ww, Gll^Fdf, Gll^Fdf, Gll^Fdf, Ss, Gll^Fdf, Gll^Fdf, Gll^Fdf, Gll^Fdf, Gll^Fdf, Gll^Fdf, Gll^Fdf, Gll^Fdf, Gll^Fdf, Gg^Fmf, Gg^Fmf, Ss, Gll^Fdf, Gll^Fdf, Gll^Fdf, Gll^Fdf, Gll^Fdf, Gll^Fdf, Gg^Em, Gll^Fdf, Cv^Em, Cvr^Fdf, Cvr^Fdf, Gll^Fdf, Gll^Fdf, Gg^Em, Gg^Em, Gg^Efm, Gg^Efm, Gg^Em, Gs^Fdf, Gll^Fdf, Gll^Fdf, Gll^Fdf
Ss, Gll^Fmf, Gll^Fdf, Gll^Fdf, Gll^Fdf, Ww, Wo, Ww, Gll^Fdf, Gll^Fdf, Gll^Fdf, Gll^Fdf, Gll^Fdf, Gll^Fdf, Gg^Ve, Gll^Fdf, Gll^Fdf, Gll^Fdf, Gll^Fdf, Gll^Fdf, Gg^Ve, Gll^Fdf, Gll^Fdf, Gll^Fdf, Gll^Fdf, Gll^Fdf, Gll^Fdf, Gll^Fdf, Gll^Fmf, Gll^Edt, Cvr^Fdf, 2 Kvr, Ww^Ewf, Ww^Ewl, Gll^Fdf, Cv^Em, Rp, Gg^Em, Gll^Fdf, Gg^Em, Gll^Fdf, Gg^Em, Gll^Fmf, Gll^Fmf, Gll^Fdf, Gll^Fdf
Ss, Gll^Fmf, Gll^Fmf, Gll^Fdf, Gll^Fdf, Ww, Wo, Ww, Ww, Gll^Fdf, Gll^Fdf, Gll^Fdf, Gll^Fdf, Gll^Fdf, Gll^Fdf, Gll^Fdf, Gll^Fdf, Gll^Fdf, Gll^Fdf, Gll^Fdf, Gll^Fdf, Gll^Fdf, Gll^Fdf, Gll^Fdf, Gll^Fdf, Gll^Fdf, Gll^Fdf, Gll^Fmf, Gll^Fmf, Gll^Fmf, Wwrg, Ww^Bs|, Rp, Rp, Rp, Rp, Gg^Em, Gll^Fdf, Gll^Fdf, Gll^Fdf, Gll^Fmf, Gll^Fdf, Gll^Fmf, Gll^Fmf, Gll^Fmf, Gll^Fdf
Ss, Ss, Gll^Fmf, Gll^Fdf, Gll^Fdf, Ww, Ww, Wo, Wo, Ww, Gll^Fdf, Gll^Fdf, Gll^Fdf, Gll^Fdf, Gll^Fdf, Gll^Fdf, Gll^Fdf, Gll^Fdf, Gll^Fdf, Gll^Fdf, Gll^Fdf, Gll^Fdf, Gll^Fdf, Gll^Fdf, Gll^Fdf, Gll^Fdf, Gll^Fdf, Gll^Fdf, Gll^Fdf, Cvr, Gg^Em, Rp, Gll^Fdf, Cvr, Gll^Fdf, Gll^Fdf, Gll^Fdf, Gll^Fdf, Gll^Fdf, Gll^Fmf, Gll^Fmf, Gg^Ve, Gll^Fdf, Gll^Fdf, Gll^Fdf, Gll^Fdf
Ss, Ss, Ss, Gll^Fdf, Gll^Fdf, Gll^Fdf, Gll^Fdf, Ww, Wo, Ww, Ww, Gll^Fdf, Gll^Fdf, Gll^Fdf, Gll^Fdf, Gll^Fdf, Gll^Fdf, Gll^Fdf, Cv, Gll^Fdf, Gll^Fdf, Gll^Fdf, Gll^Fdf, Gll^Fdf, Gll^Fdf, Gll^Fdf, Gll^Fdf, Gll^Fdf, Gll^Fdf, Cvr^Fdf, Rp, Rp, Ww^Ewl, Cvr^Fdf, Gll^Fmf, Gll^Fdf, Gll^Fdf, Gll^Fdf, Gll^Fdf, Gg^Em, Gll^Fdf, Gll^Fdf, Gll^Fdf, Gll^Fdf, Ss, Ss
Gg^Fdf, Ss, Ss, Gll^Fdf, Gll^Fmf, Gll^Fdf, Gll^Fdf, Ww, Ww, Wo, Ww, Ww, Gll^Fdf, Gll^Fdf, Gll^Fdf, Gll^Fdf, Cv, Cv, Cv, Gll^Fdf, Gll^Fdf, Gll^Fdf, Gll^Fdf, Gg^Ve, Gll^Fdf, Gll^Fdf, Rp, Rp, Rp, Rp, Ww^Ewl, Ww^Bs|, Cvr^Fdf, Cvr^Fmf, Gll^Fdf, Gll^Fmf, Gll^Fdf, Gg^Em, Gll^Fdf, Gll^Fdf, Gll^Fdf, Gll^Fdf, Gll^Fdf, Gll^Fdf, Ss, Gll^Fdf
Gg^Fdf, Ss, Ss^Fmf, Ss, Gll^Fmf, Gll^Fdf, Gll^Fdf, Gll^Fdf, Gll^Fdf, Ww, Wo, Ww, Ww, Gll^Fdf, Gll^Fdf, Cv, Cv, 6 Kv, Cv, Gll^Fdf, Gll^Fdf, Gll^Fdf, Gll^Fdf, Gll^Fdf, Rp, Rp, Gll^Fdf, Cvr, Cvr^Fdf, Ww^Ewl, Cvr, Kvr, Gll^Fdf, Gll^Fdf, Gll^Fdf, Gll^Fdf, Gll^Fdf, Gll^Fdf, Gll^Fp, Gll^Fdf, Gll^Fmf, Gll^Fdf, Gll^Fdf, Ss, Gll^Fp, Gll^Fdf
Ss, Ss, Ss, Ss, Gll^Fmf, Gll^Fdf, Gll^Fmf, Gll^Fmf, Gll^Fmf, Ww, Ww, Wo, Wo, Ww, Ww, Ww, Ww, Cv, Cv, Gll^Fdf, Gll^Fdf, Gll^Fdf, Rp, Rp, Gll^Fdf, Gll^Fdf, Gll^Fdf, Gll^Fdf, Gll^Fdf, Cvr^Fdf, Gg^Em, Gll^Fmf, Gll^Fdf, Gg^Em, Gll^Fdf, Gg^Ve, Gll^Fdf, Gll^Fdf, Gll^Fdf, Gll^Fdf, Gll^Fdf, Gll^Fmf, Gll^Fmf, Ss, Gll^Fdf, Gll^Fdf
Gll^Fdf, Ss, Ss, Gll^Fmf, Gll^Fdf, Gll^Fmf, Ss, Ss, Ss, Gll^Fmf, Gll^Fmf, Ww, Wo, Wo, Wo, Ww, Ww, Wwf, Gll^Fdf, Gll^Fdf, Rp, Rp, Gll^Fdf, Gll^Fdf, Gll^Fdf, Gll^Fdf, Gll^Fdf, Gll^Fdf, Gll^Fdf, Gll^Fdf, Gll^Fdf, Gll^Fdf, Gll^Fmf, Gll^Fdf, Gg^Em, Gll^Fdf, Gll^Fdf, Gll^Fdf, Gll^Fdf, Gll^Fdf, Gll^Fdf, Gll^Fmf, Gll^Fdf, Ss, Gll^Fp, Gll^Fdf
Gll^Fdf, Gll^Fdf, Gll^Fdf, Gll^Fdf, Gll^Fdf, Gll^Fmf, Gll^Fmf, Gll^Fmf, Gll^Fmf, Ss, Ww, Ww, Ww, Ww, Ww, Ww, Wwr, Wwf, Ww^Bsb/, Rp, Gll^Fdf, Gll^Fdf, Gll^Fdf, Gll^Fdf, Gll^Fdf, Gll^Fdf, Gll^Fdf, Gll^Fdf, Gll^Fmf, Gll^Fdf, Gg^Em, Gll^Fmf, Gg^Em, Gll^Fdf, Gg^Em, Gll^Fdf, Gll^Fp, Gll^Fmf, Ss, Gll^Fdf, Ss, Gll^Fdf, Ss, Ss, Gll^Fp, Gll^Fdf
Gll^Fdf, Gll^Fmf, Gg, Gll^Fdf, Gll^Fmf, Gll^Fmf, Ss, Gll^Fmf, Gll^Fmf, Ss, Gll^Fmf, Ww, Gs^Fmf, Gg^Fdf, Gs^Fmf, Wwr, Ww^Bsb/, Ww^Bsb/, Ww, Wwr, Cv, Gll^Fdf, Gll^Fdf, Gll^Fdf, Gll^Fdf, Gll^Fdf, Gll^Fdf, Gll^Fdf, Gll^Fdf, Gll^Fmf, Gll^Fmf, Gg^Em, Gll^Fdf, Gll^Fdf, Gll^Fdf, Gll^Fmf, Ss, Ss, Ss, Ss, Ss, Ss, Gll^Fdf, Gll^Fdf, Gll^Fdf, Gll^Fdf
Gg, Gg, Gll^Fdf, Gll^Fdf, Gll^Fmf, Ss, Gll^Fmf, Gll^Fmf, Gll^Fdf, Gll^Fmf, Gs^Fmf, Gg^Fdf, Gg^Fdf, Gg^Fdf, 1 Gll, Rp, Wwf, Wwr, Ww, Ww, Ww, Gll^Fdf, Gll^Fdf, Gll^Fdf, Gll^Fdf, Gll^Fdf, Gll^Fdf, Gll^Fdf, Gll^Fdf, Gll^Fmf, Gll^Fdf, Gll^Fdf, Gll^Fdf, Gll^Fp, Ss, Ss, Ww, Ss, 5 Kme, Ww, Ww, Ss, Gll^Fdf, Gll^Fmf, Gll^Fmf, Gll^Fdf
Gg, Gg, Gg, Gll^Fdf, Gll^Fdf, Gll^Fmf, Gll^Fdf, Gll^Fdf, Gll^Fdf, Gll^Fdf, Gll^Fdf, Gg, Gg^Fdf, Gll, Gll^Fdf, Gs^Fmf, Gll^Fp, Ww, Ww, Wo, Ww, Gll^Fdf, Gll^Fdf, Gll^Fdf, Gll^Fdf, Gll^Fdf, Gll^Fdf, Gll^Fdf, Gll^Fdf, Gll^Fmf, Gll^Fmf, Gll^Fdf, Gll^Fdf, Ss, Ss, Ww^Ewl, Ww, Cme, Ww, Ww, Ww, Ww^Ewl, Ww^Ewf, Gll^Fdf, Gll^Fdf, Gll^Fmf
Gg, Gg, Gll^Fdf, Gll^Fdf, Gll^Fdf, Gll^Fdf, Gll^Fdf, Gll^Fdf, Gll^Fmf, Gll^Fdf, Gg, Gll^Fmf, Gll, Gll, Gg^Fmf, Gll^Fdf, Gll^Fmf, Gll^Fp, Ww, Ww, Ww, Ww, Gll^Fdf, Gll^Fdf, Gll^Fdf, Gll^Fdf, Gll^Fdf, Gll^Fdf, Gll^Fdf, Gll^Fdf, Gll^Fdf, Gll^Fdf, Gll^Fdf, Ss, Ss, Ww, Ww^Ewl, Ww, Ww, Ww, Ww, Ww^Ewl, Ww^Ewl, Gll^Fdf, Gll^Fmf, Gll^Fmf
Gg, Gg, Gll^Fdf, Gll^Fdf, Gll^Fmf, Gll^Fmf, Gll^Fdf, Gll^Fdf, Gll^Fdf, Gll^Fdf, Gll, Gll, Gll^Fdf, Gg, Gll^Fdf, Gll^Fdf, Gll^Fmf, Gg^Fdf, Ww, Wo, Wo, Ww, Gll^Fdf, Gll^Fdf, Gll^Fdf, Gll^Fdf, Gll^Fdf, Gll^Fdf, Gll^Fdf, Gll^Fdf, Gll^Fdf, Gll^Fdf, Ss, Gll^Fdf, Ss, Ww^Ewl, Ss, Ww, Ww, Ww^Ewf, Ww^Ewl, Ww, Gll^Fdf, Gll^Fdf, Gll^Fmf, Gll^Fmf
Gll^Fdf, Gll^Fdf, Gll^Fdf, Gll^Fdf, Gll^Fdf, Gll^Fdf, Gll, Gll^Fdf, Gll, Gll, Gll^Fdf, Gll^Fdf, Gll^Fdf, Gg^Fmf, Gll^Fdf, Gll^Fdf, Gll^Fdf, Wwt, Ww, Wo, Ww, Ww, Gg^Fmf, Gll^Fdf, Gll^Fdf, Gll^Fdf, Gg^Fmf, Gll^Fdf, Gg^Fmf, Gll^Fdf, Gll^Fdf, Ss, Gll^Fdf, Ss, Gll^Fdf, Ss, Gll^Fdf, Gll^Fdf, Ww, Ww, Ww, Ww^Ewl, Ss, Gll^Fdf, Gll^Fmf, Gg^Fdf
Gll^Fdf, Gll^Fdf, Gll, Gll^Fdf, Gll, Gll, Gll^Fdf, Gll, Gll^Fdf, Gll^Fdf, Gg^Fmf, Gll^Fdf, Gll^Fdf, Gll^Fdf, Gll^Fdf, Gll^Fdf, Gll^Fdf, Wwt, Ww, Wo, Ww, Gg^Fmf, Ss, Gg^Fmf, Gg^Fmf, Gg^Fmf, Ss, Gll^Fp, Ss, Gg^Fmf, Gg^Fmf, Ss, Gg^Fmf, Gll^Fdf, Gll^Fdf, Gll^Fdf, Gll^Fdf, Gll^Fdf, Ww, Ww, Ww, Ss, Gll^Fdf, Gll^Fdf, Gll^Fdf, Gll^Fmf
Gll, Gll, Gll^Fdf, Gll, Gll^Fdf, Gll^Fdf, Gll^Fdf, Gll^Fdf, Gll^Fdf, Gll^Fdf, Gll^Fdf, Gll^Fdf, Gll^Fdf, Ss, Ss, Ss, Gll^Fp, Gll^Fdf, Ww, Wo, Wo, Ww, Gg^Fmf, Ss, Ss, Ss, Ss, Ss, Ss, Gll^Fp, Gg^Fmf, Ss, Gll^Fdf, Gll^Fdf, Gll^Fdf, Gll^Fdf, Ss, Ww, Ww^Ewl, Ww, Ss, Ss, Ss, Ss, Gll^Fmf, Gll^Fdf
Gll^Fdf, Gll^Fdf, Gll^Fdf, Gll^Fmf, Gll^Fmf, Gll^Fdf, Gll^Fdf, Gll^Fdf, Gll^Fdf, Gll^Fdf, Gg, Gll^Fdf, Gll^Fdf, Gll^Fdf, Ss, Gll^Fmf, Gll^Fmf, Gll^Fp, Ww, Ww, Wo, Ww, Gll^Fdf, Gll^Fdf, Gg^Fmf, Ss, Ss, Ss, Ss, Ss, Ss, Ss, Gg^Fmf, Gll^Fdf, Gll^Fdf, Gll^Fdf, Gll^Fdf, Ss, Ss, Ss, Ss, Gll^Fmf, Gll^Fp, Gll^Fmf, Gll^Fmf, Gll^Fdf
Gg, Gg, Gg, Gll^Fdf, Gll^Fdf, Gll^Fdf, Gg, Gg, Gll^Fmf, Gg, Gll^Fdf, Gll^Fdf, Gll^Fdf, Gll^Fdf, Ss, Gll^Fmf, Gll^Fmf, Gll^Fmf, Ww, Ww, Wo, Ww, Ss, Gll^Fdf, Gg^Fmf, Ss, Gg^Fp, Ss, Gg^Fmf, Ss, Gg^Fmf, Gg^Fmf, Gg^Fmf, Gll^Fdf, Gll^Fdf, Gll^Fdf, Gll^Fdf, Gll^Fdf, Ss, Ss, Ss, Gll^Fmf, Gll^Fmf, Gll^Fdf, Gll^Fdf, Gll^Fdf
Gg, Gg, Gll^Fdf, Gll^Fdf, Gll^Fdf, Gll^Fdf, Gg, Gg, Gll^Fdf, Gll^Fdf, Gll^Fdf, Gll^Fdf, Ss, Ss, Ss, Gll^Fmf, Gll^Fmf, Ww, Wo, Wo, Ww, Ww, Gll^Fdf, Gll^Fdf, Gll^Fdf, Gll^Fdf, Gll^Fdf, Gg^Fp, Gll^Fdf, Gll^Fdf, Gll^Fdf, Gll^Fdf, Gll^Fdf, Gll^Fdf, Gll^Fdf, Gll^Fdf, Gll^Fdf, Ss, Ss, Ss, Gll^Fmf, Ss, Gll^Fmf, Gll^Fmf, Gll^Fdf, Gll^Fdf
Gll^Fdf, Gll^Fdf, Gll^Fdf, Gll^Fdf, Gg, Gg, Gg, Gll^Fdf, Gll^Fdf, Gll^Fdf, Gll^Fdf, Ss, Gg^Fdf, Ss, Gll^Fmf, Gll^Fmf, Gll^Fmf, Ww, Wo, Ww, Gll^Fdf, Gll^Fdf, Gll^Fdf, Gll^Fdf, Gll^Fdf, Gll^Fdf, Gll^Fdf, Gll^Fdf, Gll^Fdf, Gll^Fdf, Gll^Fdf, Gll^Fdf, Gll^Fdf, Gll^Fdf, Gll^Fdf, Gll^Fdf, Gll^Fdf, Ss, Ss, Ss, Gll^Fmf, Gll^Fmf, Gll^Fmf, Gll^Fmf, Gll^Fdf, Gll^Fdf
