Xu, Xu, Xu, Xu, Xu, Xu, Xu, Xu, Xu, Xu, Xu, Xu, Xu, Xu, Xu, Xu, Xu, Xu, Xu, Qxu, Qxu, Qxu, Xu, Xu, Xu, Xu, Xu, Xu, Xu, Xu, Xu, Xu, Xu, Xu, Xu, Xu, Xu, Uu
Wog, Xu, Xu, Xu, Wog^Vm, Xu, Xu, Xu, Wog, Xu, Wog, Xu, Wog, Xu, Wog, Xu, Wog, Xu, Qxu, Qxu, Qxu, Qxu, Qxu, Xu, Xu, Xu, Xu, Xu, Xu, Xu, Xu, Xu, Xu, Xu, Uh^Em, Xu, Ur, Ur
Wog, Wog, 4 Kme, Wog, Wog, Wog, Wog, Wog, Wwrg, Wog, Wog, Wog, Wog, Wog, Wog, Wog, Wog, Qxu, Qxu, Qxu, Qxu, Qxu, Xu, Qxu, Qxu, Qxu, Qxu, Xu, Uu, Ur^Ebn, Ur, Uu, Ur, Uu^Vu, Ur, Ur, Xu, Xu
Wog, Wog, Wog, Cme, Wwrg, Wog, Wwrg, Wog, Wog, Wog, Wog, Wog, Wog, Wog, Wog, Wog, Xu, Xu, Xu, Xu, Xu, Xu, Xu, Xu, Xu, Qxu, Xu, Uu^Vu, Uu, Ur, Cte, Ur, Cte, Ur, Xu, Xu, Xu, Xu
Wog, Wog, Wog^Vm, Wog, Wog, Wwrg, Wog, Wog, Wog, Wog, Wog, Wog, Wog, Xu, Xu, Xu, Qxu, Qxu, Qxu, Xu, Xu, Xu, Xu, Xu, Uh, Xu, Xu, Xu, Uu, Ur, Cte, 2 Ko, Ur, Ur, Uu, Xu, Xu, Xu
Xu, Xu, Xu, Wog, Wog, Wog, Wog, Wwrg, Wog, Wog, Wwrg, Wog, Wog, Wog, Wwg, Xu, Qxu, Qxu, Qxu, Uu^Vu, Uh, Xu, Xu, Qxu, Qxu, Uh^Em, Uu, Uu, Ur, Ur, Ur, Cte, Ur, Uu, Uu^Uf, Xu, Xu, Xu
Xu, Xu, Uu^Uf, Wog, Wog, Wwrg, Wog, Wog, Wwrg, Wog, Wog, Wog, Wog, Wog, Xu, Wwg, Wwf, Qxu, Uh, Ur, Ur, Uh, Xu, Qxu, Uu, Qxu, Qxu^Bs/, Ur, Ur, Ur, Uu, Ur, Ur^Ebn, Uu, Uu^Vu, Xu, Xu, Xu
Xu, Xu, Wwg, Wwg, Wwrg, Wog, Wog, Wog, Wog, Wog, Wog, Wwrg, Wog, Wog, Xu, Xu, Qxu, Wwf, Wwf, Uu^Uf, Wwf, Wwf, Wwf, Uh, Uu^Uf, Ur, Ur, Qxu^Bs/, Qxu, Uu^Vu, Uu, Xu, Xu, Xu, Qxu, Qxu, Xu, Xu
Xu, Xu, Wwrg, Wwg, Wwg, Wwg, Wwg, Wog, Wwrg, Wog, Wog, Wog, Wog, Wog, Xu, Qxu, Qxu, Uu, Uu^Em, Wwf, Ur, Ur, Uu^Uf, Wwf, Wwf, Ur, Uu^Uf, Uu^Es, Qxu, Qxu, Uu, Uu^Uf, Uh, Xu, Qxu, Qxu, Xu, Xu
Xu, Wwg^Es, Wwg, Wwg, Wwg, Wwg, Wwg, Wwrg, Wwg, Wog, Wog, Wog, Xu, Wwg, Wwg, Xu, Uh, Qxu, Ur, Ur, Uu^Vu, Uu^Uf, Uh, Uh, Ur, Wwf, Wwf, Uu, Qxu, Qxu, Uh, Uu, Xu, Xu, Xu, Qxu, Xu, Xu
Xu, Wwg, Wwg, Wwg, Wwrg, Wwg, Wwg, Wwg, Xu, Xu, Xu, Xu, Xu, Xu, Xu, Wwg, Wwf, Ur, Uu^Es, Uu, Qxu, Qxu, Qxu, Ur, Uu^Uf, Uh, Uh, Wwf, Uu^Uf, Xu, Wwg, Wwg, Wwg, Xu, Qxu, Qxu, Qxu, Qxu
Xu, Wwrg, Wwg, Wwg, Wwg, Wwg, Wwg, Uu^Uf, Qxu, Qxu, Qxu, Uu^Uf, Qxu, Qxu, Qxu, Xu, Wwf, Wwf, Wwg, Uu, Uu^Uf, Qxu, Ur, Ur, Ur, Uh, Uu^Uf, Wwf, Wwf, Xu, Wwg, Wwg, Wwg, Xu, Qxu, Qxu, Qxu, Qxu
Xu, Wwg, Ur, Wwg, Ur, Ur, Wwg, Uu^Em, Uh, Qxu, Xu, Qxu, Xu, Qxu, Xu, Wwg, Uu, Ur, Uu, Wwg, Uu^Uf, Uu, Ur, Uu^Uf, Uh, Ur, Ur^Vu, Ur, Xu, Wwg, Wwg, Wwg, Wwg, Xu, Xu, Qxu, Xu, Xu
Xu, Wwg, Wwg, Ur, Uu^Es, Uh, Xu, Wwg, Wwg, Xu, Xu, Xu, Xu, Xu, Wwg, Wwg, Ur, Ur^Vu, Ur, Wwg, Wwf, Wwf, Wwg, Uu^Em, Uu^Uf, Uu^Es, Ur, Uu, Wwg, Wwg, Xu, Wwg, Xu, Xu, Qxu, Qxu, Xu, Xu
Xu, Xu, Wwg, Ur, Uu^Vu, Xu, Xu, Xu, Wwg, Xu, Xu, Xu, Wwg, Wwg, Ur, Ur, Uu, Uu, Uu, Ur, Uh, Uu^Uf, Xu, Wwg, Wwg, Wwg, Wwf, Wwf, Wwf, Uh, Uu^Uf, Xu, Xu, Xu, Qxu, Xu, Xu, Xu
Xu, Wwg, Ur^Es, Ur, Uu^Uf, Xu, Xu, Xu, Xu, Wwg, Wwf, Wwg, Uu^Es, Uu, Ur, Uu, Xu, Uu^Uf, Uu, Ur, Uu^Es, Xu, Wwg, Wwg, Xu, Uu^Uf, Ur, Wwg, Xu, Wwf, Ur, Uu, Uu^Uf, Xu, Xu, Uh, Uh, Xu
Xu, Wwg, Ur, Uu, Uu^Uf, Xu, Xu, Xu, Uu, Ur, Xu, Wwf, Wwf, Ur, Uh, Xu, Uh, Xu, Uh, Ur, Ur, Wwf, Ur, Xu, Uh, Uu, Ur, Xu, Xu, Wwg, Xu, Ur, Ur, Xu, Uh^Em, Uh, Uh, Xu
Xu, Wwg, Ur, Uu, Xu, Xu, Uu, Uu, Xu, Xu, Uu^Uf, Uu, Ur, Wwg, Wwg, Xu, Uh, Uh, Xu, Uu, Wwf, Wwf, Uu, Ur, Ur, Uh, Ur, Uh, Xu, Wwg, Wwg, Xu, Xu, Ur, Uh, Uh, Uh, Xu
Xu, Wwg, Wwg, Ur, Ur, Ur, Xu, Xu, Xu, Xu, Uh, Uh, Ur, Uh^Es, Xu, Wwg, Wwg, Wwg, Wwg, Uu^Uf, Wwf, Uu^Uf, Xu, Uu^Vu, Ur, Uu, Ur, Xu, Uu^Vu, Xu, Uu^Uf, Wwg, Wwf, Ur, Uu, Uh, Uh, Xu
Uu, Xu, Wwg, Ur, Uu^Uf, Xu, Xu, Xu, Uu^Vu, Xu, Uu, Uh, Ur, Ur, Ur, Wwg, Uu, Uu^Uf, Uu, Wwf, Uu^Uf, Wwg, Wwg, Xu, Uu, Ur, Uh, Ur, Ur, Uu^Es, Uu, Xu, Wwf, Uu, Uu, Uu^Vu, Xu, Xu
Uu, Uu, Uu, Wwf, Wwf, Xu, Xu, Xu, Uu^Uf, Ur, Ur, Ur, Uh, Uu^Em, Uu, Wwf, Ur, Uu^Uf, Uu, Ur, Uu, Xu, Xu, Wwg, Wwg, Ur, Uh, Ur, Uu^Uf, Ur, Ur, Ur, Wwf, Ur, Ur, Uh, Xu, Xu
Xu, Uu, Uu^Uf, Ur, Uu, Wwg, Wwg, Xu, Uu, Ur, Uh, Xu, Xu, Xu, Xu, Wwg, Uu, Ur, Uu^Vu, Ur, Uu, Uu^Uf, Ur, Wwg, Wwf, Wwf, Wwf, Wwf, Wwg, Uh, Xu, Uh, Wwg, Uu^Uf, Ur, Uu, Uu^Uf, Xu
Xu, Xu, Uu^Uf, Ur, Uh, Ur, Ur, Wwg, Wwg, Ur, Uu, Xu, Xu, Xu, Wwg, Wwg, Xu, Uu, Ur, Ur, Ur, Ur, Uu, Ur, Wwf, Ur, Uh, Wwg, Xu, Wwg, Wwg, Xu, Wwg, Uu, Ur, Uh, Xu, Xu
Xu, Xu, Uu, Ur, Uu, Ur, Ur, Ur, Ur, Wwf, Wwf, Uh, Xu, Xu, Wwg, Xu, Uu, Uu, Ur, Uu^Uf, Uh, Uh, Xu, Xu, Wwg, Ur, Uh, Xu, Xu, Xu, Xu, Wwg, Wwg, Uu, Ur, Uu^Es, Xu, Xu
Xu, Xu, Uu^Vu, Ur, Ur, Ur, Ur, Ur, Ur, Uu^Uf, Wwf, Ur, Wwg, Wwg, Xu, Wwg, Wwf, Ur, Uu^Em, Uu^Uf, Xu, Xu, Uh^Vu, Wwg, Ur, Ur, Ur, Uu, Xu, Xu, Xu, Xu, Wwf, Ur, Uu^Vu, Uu, Wwg, Wwg
Xu, Xu, Xu, Uh, Ur, Uu, Ur, Ur, Ur, Uh, Wwg, Wwf, Uu^Uf, Xu, Uu^Vu, Uu, Ur, Wwg, Wwg, Xu, Xu, Xu, Wwf, Wwf, Ur, Xu, Ur, Uu^Vu, Xu, Xu, Xu, Uh, Ur, Wwf, Wwf, Wwg, Wwg, Wwg
Mm, Xu, Xu, Xu, Xu, Xu, Xu, Ur, Xu, Xu, Ur, Ur, Uu^Uf, Xu, Uu^Uf, Ur, Uu, Xu, Xu, Wwg, Wwg, Wwg, Ur, Ur, Uu, Ur, Uh, Ur, Ur, Xu, Xu, Uu, Ur, Uu^Uf, Xu, Wwg, Xu, Xu
Mm, Mm, Mm, Mm, Mm, Xu, Xu, Xu, Cud, Xu, Ur, Ur, Ur, Uu, Ur, Ur, Uu, Uh, Uu, Xu, Ur, Wwf^Es, Wwg, Xu, Uu^Uf, Ur, Uh^Em, Uu, Xu, Ur, Ur, Ur, Wwf, Xu, Wwg, Wwg, Xu, Xu
Mm, Mm, Mm, Mm, Mm, Mm, Cud, Cud, Mm, Mm, Ur, Ur, Uu, Ur, Uu, Ur, Uu, Uu, Uu, Uu, Uu, Xu, Wwg, Xu, Xu, Ur, Uh, Uu, Xu, Xu, Wwf, Wwf, Uu^Es, Wwf, Xu, Xu, Xu, Xu
Hh, Mm, Hh, Mm, Mm, Mm, Cud, Mm, Mm, Mm, Mm, Mm, Xu, Uu, Uu, Uh^Es, Xu, Uu, Uu, Uu, Uu, Xu, Wwg, Xu, Wwg^Es, Ur, Ur, Ur, Xu, Wwf, Uu, Uu^Uf, Uh, Uh, Uu^Uf, Xu, Xu, Xu
Hh, Hh, Hh, Hh, Hh, Hh, Cud, 1 Kud, Mm, Mm, Cud, Cud, Xu, Uu, Uue, Uu, Xu, Uu, Uu, Uu, Uu, Uh, Uu^Em, Wwg, Uu^Uf, Wwf, Wwg, Xu, Wwg, Wwf, Uh^Em, Uh, Uh, Uh, Uh^Em, Xu, Xu, Xu
Gs, Gs, Gs, Hh, Hh, Hh, Hh, Cud, Cud, Cud, Xu, Xu, Uue, Uue, Uue, Uue, Xu, Uu, Uu, Uu, Uu, Ur, Ur, Wwg, Uu, Ur, Uu, Wwg, Uh, Uh, Uh, Uh, Uh, Uh, Uh, Uh, Uh, Xu
Gll^Fmf, Gll^Fmf, Gs, Gs, Gs, Hh, Hh, Hh, Mm, Xu, Xu, Uue, Uue, Uue, Uue, Uue, Xu, Uu, Uu, Uu, Xu, Xu, Wwg, Wwf, Ur, Ur, Uu^Uf, Uh, Uh^Em, Uh, Uu^Uf, Uh, Uh, Uh, Uu^Uf, Uh, Xu, Xu
Gll^Fmf, Gll^Fmf, Gll^Fmf, Gll^Fmf, Gll^Fmf, Gs, Gs, Hh, Hh, Mm, Mm, Xu, Xu, Uue, Uue, Xu, Qxu, Uu, Uu, Uu, Qxu, Wwg, Wwg, Wwg, Ur, Uu^Uf, Uu^Uf, Uh, Uh, Uh, Uh, Uh, Uh^Vud, Uh, Uh, Uh, Xu, Xu
Gll^Fdf, Gll^Fmf, Gll^Fmf, Gll^Fdf, Gll^Fdf, Gs, Gll^Fmf, Gs, Gs, Hh, Mm, Xu, Xu, Xu, Xu, Qxu, Qxu, Qxu, Uu, Uu, Qxu, Qxu, Wwg, Wwg, Uu^Uf, Ur, Ur, Uh, Uh^Em, Uh, Uh, Uh^Es, Uh, Uh, Uh, Uh, Uh^Vud, Xu
Gll^Fdf, Gll^Fdf, Gll^Fmf, Gll^Fmf, Gll^Fmf, Gll^Fmf, Gll^Fmf, Gs, Gs, Hh, Hh, Mm, Xu, Qxu, Uu, Qxu, Qxu, Qxu, Xu, Qxu, Qxu, Qxu, Xu, Xu, Uh, Uh, Uu^Uf, Uh^Es, Uh, Uh, Uu^Uf, Uh, Uh, Cte, 3 Kte, Uh, Uh, Xu
Gll^Fdf, Gll^Fmf, Gll^Fmf, Gll^Fmf, Gll^Fdf, Gll^Fdf, Gll^Fdf, Gll^Fmf, Gll^Fmf, Gs, Hh, Mm, Mm, Xu, Xu, Uu, Uu, Uu, Xu, Xu, Qxu, Qxu, Xu, Xu, Xu, Xu, Xu, Xu, Uh^Em, Uh, Uh, Uh, Uh^Vud, Uh, Uh, Uh, Xu, Xu
Gll^Fdf, Gll^Fmf, Gll^Fmf, Gll^Fdf, Gll^Fmf, Gll^Fdf, Gll^Fmf, Gll^Fmf, Gll^Fmf, Gs, Hh, Hh, Hh, Mm, Xu, Uu, Uu, Uu, Uu, Uu, Xu, Xu, Xu, Xu, Xu, Xu, Xu, Xu, Xu, Xu, Xu, Xu, Xu, Xu, Xu, Xu, Xu, Xu
