Xu, Xu, Xu, Xu, Xu, Xu, Xu, Xu, Xu, Xu, Xu, Xu, Xu, Xu, Xu, Xu, Xu, Xu, Xu, Xu, Xu, Gg, Xu, Xu, Xu, Xu, Xu, Xu, Xu, Xu, Xoa, Ur^Ii, Ur^Ii, Xos, Xu, Xu, Xu, Xu
Xu, Xu, Xu, Xu, Xu, Xu, Xu, Xu, Xu, Xu, Xu, Xu, Xu, Xu, Xu, Xu, Xu, Xu, Xu, Xu, Xu, Xu, Xu, Xu, Xu, Xu, Xu, Xu, Xu, Xoa, Ur, Ur^Ii, Xoa, Xoa, Xu, Xu, Xu, Xu
Xu, Xu, Xu, Xu, Xu, Xu, Xu, Xu, Xu, Xu, Xu, Xu, Xu, Xu, Xu, Xu, Xu, Xu, Xu, Xu, Xu, Xu, Xu, Xu, Qxua, Qxua, Aa, Aa, Aa, Ur, Aa, Xoa, Aa, Qxua, Qxua, Xu, Xu, Xu
Xu, Xu, Xu, Xu, Xu, Xu, Xu, Xu, Xu, Xu, Xu, Xu, Xu, Xu, Xu, Xu, Xu, Xu, Xu, Xu, Xu, Xu, Xu, Xu, Qxua, Aa, Aa, Aa^Fetd, Aa, Rrc, Rrc, Aa, Aa^Vwm, Ai, Qxua, Xu, Xu, Xu
Xu, Xu, Xu, Xu, Xu, Xu, Xu, Xu, Xu, Xu, Xu, Xu, Xu, Xu, Xu, Xu, Xu, Xu, Xu, Xu, Xu, Xu, Qxua, Qxua, Ai, Aa, Rrc^Vhca, Rrc, Rrc, Aa, Rrc, Aa, Rrc, Aa, Aa, Qxua, Xu, Xu
Xu, Xu, Xu, Xu, Xu, Xu, Xu, Xu, Xu, Xu, Xu, Xu, Xu, Xu, Xu, Xu, Xu, Xu, Xu, Xu, Xu, Wwg, Wwg, Wwg, Dd, Aa, Aa, Aa, Aa, Kha, 2 Kha, Rrc, Aa, Aa^Emf, Aa, Qxua, Qxua, Xu
Xu, Xu, Xu, Xu, Xu, Xu, Xu, Xu, Xu, Xu, Xu, Xu, Xu, Xu, Xu, Xu, Xu, Xu, Xu, Xu, Qxua, Wwf, Uu, Dd, Dd, Aa, Dd^Edp, Gg, Qxua, Qxua, Qxua, Kha, Rrc, Aa, Rrc^Vhca, Aa, Xu, Xu
Xu, Xu, Xu, Xu, Xu, Xu, Xu, Xu, Xu, Xu, Xu, Xu, Xu, Xu, Xu, Xu, Xu, Xu, Xu, Qxua, Wwf, Wwf, Ur, Dd, Dd^Vda, Gs, Gs, Gg, Qxua, Qxua, Qxua, Aa, Aa, Rrc, Aa^Emf, Aa, Xu, Xu
Xu, Xu, Xu, Xu, Xu, Xu, Xu, Xu, Xu, Xu, Xu, Xu, Xu, Xu, Xu, Xu, Xu, Xu, Wwf, Qxua, Wwf, Wwg, Uu^Tf, Dd, Hd, Hd, Dd^Edp, Gg, Dd^Do, Qxua, Gg, Aa, Aa, Aa, Aa, Aa, Xu, Xu
Xu, Xu, Xu, Xu, Xu, Xu, Xu, Xu, Xu, Xu, Xu, Xu, Xu, Xu, Xu, Xu, Xu, Wwf, Wwg, Wwg, Ur, Uu, Wwg, Uh, Dd, Dd, Dd^Edp, Dd^Edp, Gs, Gg, Dd^Edp, Gg, Hd, Dd, Aa, Qxua, Xu, Xu
Xu, Xu, Xu, Xu, Xu, Xu, Xu, Xu, Xu, Xu, Xu, Xu, Xu, Xu, Xu, Xu, Xu, Xu, Wwg, Uu, Ur, Uu^Vud, Uu^Tf, Wwg, Uu^Tf, Dd, Dd, Gd^Ecf, Hd, Dd^Edp, Dd^Edp, Gs, Dd^Vdt, Hd, Qxua, Qxua, Xu, Xu
Xu, Xu, Xu, Xu, Xu, Xu, Xu, Xu, Xu, Xu, Xu, Xu, Xu, Xu, Xu, Xu, Xu, Xoa, Uu^Tf, Wwg, Ur, Uue, Wwg, Wwg, Wwg, Dd, Dd, Dd, Hd, Dd, Dd, Dd, Dd, Dd, Uu^Vud, Xu, Xu, Xu
Xu, Xu, Xu, Xu, Xu, Xu, Xu, Xu, Xu, Xu, Xu, Xu, Xu, Xu, Xu, Xu, Xoa, Xoa, Ur, Wwg, Wwf, Wwg, Xu, Xu, Xu, Uue, Uue, Dd, Xu, Dd, Wwf, Dd, Uue, Uu, Qxua, Xu, Xu, Xu
Xu, Xu, Xu, Xu, Xu, Xu, Xu, Xu, Xu, Xu, Xu, Xu, Xu, Xu, Xu, Xu, Uue, Uh, Uue, Ur, Xoa, Uu^Tf, Qxua, Qxua, Qxua, Uue, Uu^Vud, Qxua, Qxua, Xu, Wwf, Wwf, Wwg, Qxua, Qxua, Xu, Xu, Xu
Xu, Xu, Xu, Xu, Xu, Xu, Xu, Xu, Xu, Xu, Xu, Xu, Xu, Xu, Uue, Wwg, Ur, Uue, Ur, Ur, Wwg, Ur, Ur, Qxua, Qxua^Br|, Qxua^Br/, Uue, Uh, Ur, Wwg, Uu, Ur, Uue, Wwg, Uu^Tf, Qxua, Xu, Xu
Xu, Xu, Xu, Xu, Xu, Xu, Xu, Xu, Xu, Xu, Xu, Xu, Xu, Xu, Wwg, Wwg, Wwg, Ur, Uue, Uh, Uu^Tf, Wwf, Wwg, Cfr, 3 Kfr, Qxua, Ur, Ur, Wwg, Wwf, Ur, Ur, Ur, Wwg, Wwf, Wwf, Xu, Xu
Xu, Xu, Xu, Xu, Xu, Xu, Xu, Xu, Xu, Xu, Xu, Xu, Uh, Uue, Uu, Wwg, Wwg, Ur, Uu^Vud, Uu, Uh, Uu^Tf, Wwg, Cfr, Cfr, Cfr, Wwf, Wwg, Ur, Ur, Uu, Uue, Uue, Ur, Uh, Xu, Xu, Xu
Mm^Xm, Xu, Xu, Xu, Xu, Xu, Xu, Xu, Xu, Xu, Xu, Uu^Tf, Uue, Uh^Vud, Uu, Wwg, Uh, Ur, Uu^Tf, Uue, Uue, Uue, Xu, Wwg, Wwg^Br|, Wwrg, Uu, Ur, Xoa, Uh, Uue, Uu^Tf, Uue, Uue, Xu, Xu, Xu, Xu
Mm^Xm, Mm^Xm, Mm^Xm, Xu, Xu, Xu, Xu, Xu, Xu, Xu, Xu, Wwg, Wwg, Uue, Wwg, Wwg, Uu, Ur, Uue, Xu, Xu, Xu, Wwg, Wwf^Br/, Xu, Wwg, Wwf, Ur, Uh, Ur, Ur, Ur, Xoa, Xoa, Xu, Xu, Xu, Xu
Mm, Mm^Xm, Mm^Xm, Xu, Mm^Xm, Xu, Xu, Xu, Xu, Xu, Uu, Uh, Wwf, Wwg, Wwg, Wwg, Uu, Ur, Xu, Xu, Wwf^Br/, Wwg, Uue, Xu, Uu^Tf, Uue, Ur, Wwg, Wwg, Ur, Uh, Xoa, Xu, Xu, Xu, Xu, Xu, Xu
Mm, Mm, Mm, Mm^Xm, Mm^Xm, Xu, Xu, Xu, Xu, Uu, Uh, Uu, Wwf, Uh, Uh, Wwf, Wwf, Ur, Uu^Br|, Ur^Br/, Uue, Uue, Xu, Xu, Uue, Uh, Ur, Uh, Xu, Wwg, Uue, Xoa, Xu, Xu, Xu, Xu, Xu, Xu
Hh, Mm, Mm, Mm, Mm^Xm, Xu, Xu, Xu, Xu, Uh, Uu, Wwg, Wwf, Uu, Ur, Ur, Wwg, Ur, Uu^Br|, Xu, Xu, Xu, Uu^Vud, Uh, Uh, Uu, Ur, Ur, Ur, Wwg, Uue, Xu, Xu, Xu, Xu, Xu, Xu, Xu
Hh^Fp, Mm^Fp, Mm, Mm, Mm, Mm^Xm, Mm^Xm, Xu, Xu, Xu, Uu, Uu, Wwf, Ur, Uh, Uu, Uh, Wwf, Wwf, Xu, Xu, Xu, Uu^Tf, Ur, Ur, Ur, Uh, Uue, Uue, Wwf, Uu^Vud, Xu, Xu, Xos, Xu, Xu, Xu, Xu
Hh^Fp, Hh^Fp, Hh^Fp, Mm^Fp, Mm^Fp, Mm, Mm^Xm, Xu, Xu, Xu, Xu, Uh, Ur, Wwf, Uu, Uh, Ur, Ur, Uu^Br|, Wwg, Wwg, Xu, Uu, Ur, Uh, Xu, Xu, Xu, Xu, Wwg, Uue, Xu, Xu, Xu, Xu, Xu, Xu, Xu
Hh^Fp, Hh^Fp, Hh^Fp, Mm, Mm, Mm, Mm, Mm^Xm, Gs^Em, Xu, Xoa, Ur, Ur, Wwf, Wwf, Ur, Uu^Tf, Ur, Wwf, Wwg, Uu, Wwg, Wwg, Ur, Uu, Xu, Xu, Xu, Wwg, Wwg, Xu, Xu, Xu, Xu, Xu, Xu, Xu, Xu
Gll^Fmf, Hh^Fp, Hh^Fp, Hh^Fp, Hh^Fp, Mm, Mm, Mm, Gs, Gs, Mm, Ur, Ur, Ur, Ur, Wwf, Ur, Ur, Cfr, Ur, Ur, Uu^Tf, Uu^Tf, Wwf, Wwf, Uh, Xu, Xu, Wwg, Xu, Xu, Xu, Xu, Xu, Xu, Xu, Xu, Xu
Gll^Fdf, Gll^Fmf, Gll^Fmf, Hh^Fp, Hh^Fp, Mm^Fp, Mm, Mm, Mm, Mm, Mm, Mm, Gs^Em, Xoa, Ur, Wwf, Cfr, Cfr, 1 Kfr, Cfr, Ur, Uu, Ur, Ur, Wwf, Ur, Wwg, Wwg, Xu, Xu, Xu, Xu, Xu, Xu, Xu, Xu, Xu, Xu
Gll^Fdf, Gll^Fmf, Gll^Fmf, Hh^Fp, Hh^Fp, Hh, Hh^Fp, Mm^Fp, Mm, Mm, Mm, Mm, Mm, Gs, Gs^Em, Ur, Cfr, Ur, Ur, Cfr, Ur, Ur, Uu, Uh, Wwg, Wwf, Uu^Tf, Xu, Xu, Xu, Xu, Xu, Xu, Xu, Xu, Xu, Xu, Xu
Gll^Fdf, Gll^Fmf, Gll^Fmf, Gll^Fmf, Hh^Fp, Hh^Fp, Hh^Fmf, Hh^Fp, Hh^Fp, Hh^Fp, Hh^Fp, Mm, Hh, Gs, Mm, Mm, Gs, Cfr, Cfr, Cfr, Ur, Ur, Ur, Uh, Uh, Wwg, Xu, Xu, Xu, Xu, Xu, Xu, Xu, Xu, Xu, Xu, Xu, Xu
Gll^Fmf, Gll^Fmf, Gll^Fmf, Gll^Fmf, Gll^Fmf, Gll^Fmf, Gll^Fmf, Hh^Fp, Hh^Fp, Hh, Hh^Fp, Hh, Hh^Fp, Hh, Hh, Mm, Gs, Gs^Em, Mm, Ur, Ur, Ur, Ur, Ur, Uu, Uu, Xu, Xu, Xu, Xu, Xu, Xu, Xu, Xu, Xu, Xu, Xu, Xu
Gll^Fmf, Gll^Fmf, Gll^Fmf, Gll^Fmf, Gll^Fmf, Gll^Fmf, Gll^Fmf, Gll^Fdf, Gll^Fmf, Gll^Fmf, Gll^Fmf, Hh^Fp, Gll^Fmf, Hh^Fp, Hh, Mm, Mm, Mm, Mm, Gs, Gs, Xoa, Ur, Ur, Ur, Uh, Uh, Xu, Xu, Xu, Xu, Xu, Xu, Xu, Xu, Xu, Xu, Xu
Gll^Fmf, Gll^Fmf, Gll^Fmf, Gll^Fmf, Gll^Fdf, Gll^Fmf, Gll^Fmf, Gll^Fmf, Gll^Fdf, Gll^Fmf, Gll^Fmf, Gll^Fp, Gll^Fmf, Gll^Fmf, Gll^Fp, Hh^Fp, Hh, Mm, Mm, Mm, Mm, Mm, Gs, Ur, Xoa, Ur, Xoa, Xoa, Xu, Xu, Xu, Xu, Xu, Xu, Xu, Xu, Xu, Xu
Gll^Fmf, Gll^Fmf, Gll^Fdf, Gll^Fdf, Gll^Fdf, Gll^Fdf, Gll^Fmf, Gll^Fmf, Gll^Fmf, Gll^Fmf, Gll^Fmf, Gll^Fmf, Gll^Fmf, Gll^Fmf, Gll^Fmf, Gll^Fp, Hh^Fp, Hh^Fp, Hh, Hh, Mm, Mm, Mm, Mm, Gs, Xoa, Xoa, Xu, Xu, Xu, Xu, Xu, Xu, Xu, Xu, Xu, Xu, Xu
Gll^Fmf, Gll^Fdf, Gll^Fdf, Gll^Fdf, Gll^Fmf, Gll^Fmf, Gll^Fmf, Gll^Fmf, Gll^Fdf, Gll^Fdf, Gll^Fdf, Gll^Fdf, Gll^Fmf, Gll^Fmf, Gll^Fmf, Gll^Fmf, Hh^Fp, Hh, Hh, Hh, Hh, Mm, Mm, Mm, Mm, Gs, Mm^Xm, Xu, Xu, Xu, Xu, Xu, Xu, Xu, Xu, Xu, Xu, Xu
Gll^Fdf, Gll^Fdf, Gll^Fdf, Gll^Fdf, Gll^Fmf, Gll^Fmf, Gll^Fdf, Gll^Fdf, Gll^Fmf, Gll^Fdf, Gll^Fdf, Gll^Fdf, Gll^Fdf, Gll^Fmf, Gll^Fmf, Gll^Fdf, Gll^Fmf, Hh^Fp, Hh, Hh, Hh, Hh, Mm, Mm, Mm^Xm, Mm^Xm, Xu, Xu, Xu, Xu, Xu, Xu, Xu, Xu, Xu, Xu, Xu, Xu
Gll^Fdf, Gll^Fdf, Gll^Fmf, Gll^Fdf, Gll^Fmf, Gll^Fmf, Gll^Fmf, Gll^Fmf, Gll^Fdf, Gll^Fdf, Gll^Fdf, Gll^Fdf, Gll^Fdf, Gll^Fmf, Gll^Fmf, Gll^Fmf, Gll^Fmf, Gll^Fmf, Gll^Fmf, Hh^Fp, Hh^Fp, Hh, Mm, Mm, Mm^Xm, Xu, Xu, Xu, Xu, Xu, Xu, Xu, Xu, Xu, Xu, Xu, Xu, Xu
Gll^Fmf, Gll^Fmf, Gll^Fmf, Gll^Fdf, Gll^Fmf, Gll^Fmf, Gll^Fmf, Gll^Fmf, Gll^Fmf, Gll^Fmf, Gll^Fdf, Gll^Fdf, Gll^Fmf, Gll^Fmf, Gll^Fdf, Gll^Fmf, Gll^Fmf, Gll^Fdf, Gll^Fdf, Hh^Fp, Mm, Mm, Mm, Mm, Mm^Xm, Xu, Xu, Xu, Xu, Xu, Xu, Xu, Xu, Xu, Xu, Xu, Xu, Xu
Gll^Fdf, Gll^Fmf, Gll^Fdf, Gll^Fdf, Gll^Fdf, Gll^Fdf, Gll^Fdf, Gll^Fdf, Gll^Fmf, Gll^Fmf, Gll^Fmf, Gll^Fmf, Gll^Fmf, Gll^Fmf, Gll^Fdf, Gll^Fdf, Gll^Fmf, Gll^Fmf, Hh^Fp, Hh^Fp, Mm, Mm, Mm, Mm, Mm, Mm^Xm, Xu, Xu, Xu, Xu, Xu, Xu, Xu, Xu, Xu, Xu, Xu, Xu
Gll^Fdf, Gll^Fdf, Gll^Fdf, Gll^Fdf, Gll^Fdf, Gll^Fdf, Gll^Fdf, Gll^Fdf, Gll^Fdf, Gll^Fmf, Gll^Fdf, Gll^Fmf, Gll^Fmf, Gll^Fmf, Gll^Fdf, Gll^Fmf, Gll^Fmf, Gll^Fmf, Hh^Fp, Hh, Hh, Mm, Mm, Mm, Mm, Mm^Xm, Mm^Xm, Xu, Xu, Xu, Xu, Xu, Xu, Xu, Xu, Xu, Xu, Xu
Gll^Fdf, Gll^Fdf, Gll^Fdf, Gll^Fdf, Gll^Fmf, Gll^Fdf, Gll^Fdf, Gll^Fdf, Gll^Fmf, Gll^Fdf, Gll^Fdf, Gll^Fdf, Gll^Fmf, Gll^Fmf, Gll^Fdf, Gll^Fmf, Gll^Fmf, Gll^Fdf, Gll^Fmf, Hh^Fp, Hh^Fp, Mm, Mm, Mm, Md, Mm^Xm, Mm^Xm, Mm^Xm, Xu, Xu, Xu, Xu, Xu, Xu, Xu, Xu, Xu, Xu
Gll^Fmf, Gll^Fdf, Gll^Fdf, Gll^Fmf, Gll^Fmf, Gll^Fdf, Gll^Fdf, Gll^Fdf, Gll^Fdf, Gll^Fmf, Gll^Fmf, Gll^Fmf, Gll^Fmf, Gll^Fmf, Gll^Fmf, Gll^Fmf, Gll^Fmf, Gll^Fmf, Gll^Fmf, Hh^Fp, Hh, Mm, Hh, Hh, Hh, Mm, Mm^Xm, Mm^Xm, Mm^Xm, Xu, Xu, Xu, Xu, Xu, Xu, Xu, Xu, Xu
Gll^Fmf, Gll^Fmf, Gll^Fdf, Gll^Fmf, Gll^Fmf, Gll^Fdf, Gll^Fdf, Gll^Fdf, Gll^Fdf, Gll^Fmf, Gll^Fmf, Gll^Fmf, Gll^Fmf, Gll^Fmf, Gll^Fdf, Gll^Fdf, Gll^Fmf, Gll^Fmf, Gll^Fmf, Hh, Hh, Hh, Hh^Fp, Hh, Hh, Hh, Hh, Mm^Xm, Mm^Xm, Mm^Xm, Mm^Xm, Xu, Xu, Xu, Xu, Xu, Xu, Xu
