Rr, Xu, Xu, Xu, Xu, Xu, Xu, Wwg, Xu, Xu, Xu, Xu, Xu, Xu, Xu, Xu, Xu, Xu, Xu, Qxu, Qxu, Qxu, Xu, Xu, Xu, Xu, Xu, Xu, Xu, Wwg, Uu, Xu, Xu, Xu, Xu, Xu, Xu, Uu
Xu, Rr, Rr, Xu, Uu^Vu, Uh, Uu^Uf, Wwg, Uh, Xu, Uu^Uf, Xu, Uh, Xu, Uu^Uf, Xu, Uu, Xu, Qxu, Uu, Qxu, Qxu, Qxu, Xu, Ur, Xu, Ur, Xu, Xu, Wwg, Uu, Xu, Uu, Uu^Uf, Uu, Xu, Rr, Rr
Xu, Xu, Rr, Uu, Rr, Uu, Uu^Uf, Wwg, Uu, Uu, Uu, Uh, Uu, Uu, Wwg, Uu, Uu, Qxu, Qxu, Uu, Ur, Ur, Ur, Ur, Uu^Vu, Ur, Qxu, Ur, Ur, Wwg, Ur, Uu^Vu, Rr, Rr, Rr, Rr, Uu, Xu
Xu, Xu, Rr, Rr, Cme, Rr, Uu^Vu, Wwg, Wwg, Wwg, Wwg, Uu^Vu, Wwg, Wwg, Uu, Wwg, Wwg, Wwg, Wwf, Wwf, Wwg, Wwg, Wwg, Wwg, Wwg, Qxu, Xu, Uu^Uf, Wwg, Wwf, Uu, Ur, Rr, Cte, 2 Ko, Rr, Uu^Vu, Xu
Xu, Uu, Rr, 4 Kme, Cme, Rr, Ur, Wwf, Uu, Uu^Uf, Uu, Wwg, Wwg, Xu, Ur, Ur, Ur, Ur, Qxu, Qxu, Qxu, Qxu, Xu, Uu, Uh, Wwg, Wwg, Xu, Wwg, Uu^Uf, Uu, Uu^Uf, Rr, Cte, Cte, Rr, Uu, Xu
Xu, Uu^Vu, Rr, Cme, Rr, Rr, Uh, Wwf, Ur, Uh, Ur, Ur, Ur, Wwf, Wwg, Xu, Qxu, Ur, Ur, Uu^Vu, Uh, Xu, Xu, Qxu, Qxu, Uh^Em, Wwg, Wwg, Wwf, Uh, Ur, Ur, Uu, Rr, Rr, Rr, Uu, Xu
Xu, Uu^Uf, Uu, Rr, Uu^Uf, Ur, Wwf, Wwg, Uu^Uf, Ur, Ur, Uh, Uu, Wwg, Xu, Wwg, Wwf, Qxu, Uh, Ur, Ur, Uh, Xu, Qxu, Wwg, Wwg, Ur, Ur, Ur, Wwf, Wwf, Ur, Uh, Uu^Vu, Ur, Uu^Uf, Uh, Xu
Uh, Uu, Uu, Ur, Wwg, Wwg, Ur, Uu, Wwg, Uh, Uh, Ur, Uu, Wwg, Xu, Xu, Qxu, Wwf, Wwf, Uu^Uf, Wwf, Wwf, Wwf, Wwg, Uu^Uf, Ur, Ur, Qxu, Qxu, Ur, Uu, Wwg, Wwg, Uu, Ur, Uu, Uh, Uh
Xu, Xu, Wwg, Wwf, Wwg, Uu, Ur, Uu^Vu, Uu^Uf, Wwg, Uu^Uf, Ur, Wwg, Wwg, Xu, Qxu, Qxu, Uu, Uu^Em, Wwf, Ur, Ur, Uu^Uf, Wwf, Wwf, Ur, Uu^Uf, Qxu, Ur, Ur, Uu, Uu^Uf, Wwg, Xu, Ur, Uh, Xu, Xu
Xu, Wwg^Es, Ur, Ur, Uu^Uf, Wwg, Ur, Uu, Wwg, Wwg, Wwg, Wwf, Xu, Wwg, Wwg, Xu, Uh, Qxu, Ur, Ur, Uu^Vu, Uu^Uf, Uh, Uh, Ur, Wwf, Wwf, Ur, Qxu, Qxu, Uu^Uf, Uu, Wwg, Xu, Uu^Uf, Ur, Xu, Xu
Xu, Wwg, Ur, Uh, Uu^Uf, Wwg, Wwf, Wwg, Xu, Xu, Xu, Ur, Ur^Vu, Xu, Xu, Wwg, Wwf, Ur, Uu^Es, Uu, Qxu, Qxu, Qxu, Ur, Uu^Uf, Uh, Uh, Wwf, Uu^Uf, Xu, Uh, Wwg, Uh, Xu, Uu, Ur, Uh, Uu
Xu, Wwg, Ur, Uh, Uu, Uu, Wwf, Uu^Uf, Qxu, Qxu, Qxu, Uu^Uf, Ur, Qxu, Qxu, Xu, Wwf, Wwf, Wwg, Uu, Uu^Uf, Qxu, Ur, Ur, Ur, Uh, Uu^Uf, Wwf, Wwf, Xu, Wwg, Wwg, Wwg, Uu^Vu, Ur, Ur, Uu, Uu
Xu, Wwg, Ur, Uu, Ur, Ur, Wwg, Uu^Em, Uh, Qxu, Xu, Qxu, Xu, Ur, Xu, Wwg, Uu, Ur, Uu, Wwg, Uu^Uf, Uu, Ur, Uu^Uf, Uh, Ur, Ur^Vu, Ur, Xu, Wwg, Wwg, Uu, Uu, Wwf, Wwg, Uu^Uf, Uu^Uf, Xu
Xu, Wwg, Wwg, Ur, Uu^Es, Uh, Uu^Uf, Wwg, Wwg, Xu, Xu, Xu, Xu, Ur, Wwf, Wwg, Ur, Ur^Vu, Ur, Wwg, Wwf, Wwf, Wwg, Uu^Em, Uu^Uf, Uu^Es, Ur, Uu, Wwg, Wwg, Xu, Wwg, Uu, Ur, Ur, Wwg, Wwg, Wwg
Xu, Xu, Wwg, Ur, Uu^Vu, Uu, Uu, Uu^Uf, Wwg, Xu, Xu, Xu, Wwg, Wwg, Ur, Ur, Uu, Uu, Uu, Ur, Uh, Uu^Uf, Xu, Wwg, Wwg, Wwg, Wwf, Wwf, Wwf, Uh, Uu^Uf, Xu, Xu, Uu^Uf, Uu, Ur, Wwg, Xu
Xu, Wwg, Ur^Es, Ur, Uu^Uf, Uh, Uh, Uu, Xu, Wwg, Wwf, Wwg, Uu^Es, Uu, Ur, Uu, Xu, Uu^Uf, Uu, Ur, Uu^Es, Xu, Wwg, Wwg, Xu, Uu^Uf, Ur, Wwg, Xu, Wwf, Ur, Uu, Uu^Uf, Xu, Uh, Ur, Wwg, Xu
Xu, Wwg, Ur, Uu, Uu^Uf, Xu, Xu, Xu, Uu, Ur, Xu, Wwf, Wwf, Ur, Uh, Xu, Uh, Xu, Uh, Ur, Ur, Wwf, Ur, Xu, Uh, Uu, Ur, Xu, Xu, Wwg, Xu, Ur, Ur, Xu, Ur, Ur, Wwg, Wwg
Xu, Wwg, Ur, Uu, Xu, Xu, Uu, Uu, Xu, Xu, Uu^Uf, Uu, Ur, Wwg, Wwg, Xu, Uh, Uh, Xu, Uu, Wwf, Wwf, Uu, Ur, Ur, Uh, Ur, Uh, Xu, Wwg, Wwg, Xu, Xu, Ur, Wwf, Wwg, Uu, Xu
Xu, Wwg, Wwg, Ur, Ur, Ur, Xu, Xu, Xu, Xu, Uh, Uh, Ur, Uh^Es, Xu, Wwg, Wwg, Wwg, Wwg, Uu^Uf, Wwf, Uu^Uf, Xu, Uu^Vu, Ur, Uu, Ur, Xu, Uu^Vu, Wwg, Uu^Uf, Wwg, Wwf, Wwf, Uu, Uh, Uu, Xu
Uh, Xu, Wwg, Ur, Uu^Vu, Xu, Xu, Xu, Uu^Vu, Xu, Uu, Uh, Ur, Ur, Ur, Wwg, Uu, Uu^Uf, Uu, Wwf, Uu^Uf, Wwg, Wwg, Xu, Uu, Ur, Uh, Ur, Ur, Wwf, Uu, Xu, Wwf, Uu, Uu, Uu^Vu, Xu, Xu
Uh, Uh, Uh, Wwf, Wwf, Xu, Xu, Xu, Uu^Uf, Ur, Ur, Ur, Uh, Uu^Em, Uu, Wwf, Ur, Uu^Uf, Uu, Ur, Uu, Xu, Xu, Wwg, Wwg, Ur, Uh, Ur, Uu^Uf, Wwf, Ur, Ur, Wwf, Ur, Ur, Uh, Xu, Xu
Xu, Uh, Uu^Uf, Ur, Uu^Uf, Wwg, Wwg, Xu, Uu, Ur, Uh, Xu, Xu, Xu, Xu, Wwg, Uu, Ur, Ur^Vu, Ur, Uu, Uu^Uf, Ur, Wwg, Wwf, Wwf, Wwf, Wwf, Wwg, Wwg, Xu, Uh, Wwg, Uu^Uf, Ur, Uu, Uu^Uf, Xu
Xu, Xu, Uu^Uf, Ur, Wwf, Wwg, Uu, Wwg, Wwg, Ur, Uu, Xu, Xu, Xu, Wwg, Wwg, Xu, Uu, Ur, Ur, Ur, Ur, Uu, Ur, Wwf, Ur, Uh, Uu^Uf, Uu^Uf, Wwg, Wwg, Xu, Wwg, Uu, Ur, Uh, Xu, Xu
Wwg, Wwg, Wwg, Wwg, Uu, Ur, Ur, Uu^Uf, Uu^Uf, Wwf, Wwf, Uh, Xu, Xu, Wwg, Xu, Uu, Uu, Ur, Uu^Uf, Uh, Uh, Xu, Xu, Wwg, Ur, Uh, Xu, Xu, Wwg, Xu, Wwg, Wwg, Uu, Ur, Uu^Es, Xu, Xu
Xu, Xu, Uu^Vu, Uu, Uu^Uf, Uu, Ur, Uu, Ur, Ur, Wwf, Ur, Wwg, Wwg, Xu, Wwg, Wwf, Ur, Uu^Em, Uu^Uf, Xu, Xu, Uh^Vu, Wwg, Ur, Ur, Ur, Uu, Xu, Wwg, Xu, Xu, Wwf, Ur, Uu^Vu, Uu, Wwg, Wwg
Mm, Xu, Xu, Uh, Uu, Uu, Uu, Ur, Uu, Uh, Wwg, Wwf, Uu^Uf, Xu, Uu^Vu, Uu, Ur, Wwg, Wwg, Xu, Xu, Xu, Wwf, Wwf, Ur, Xu, Ur, Uu^Vu, Xu, Wwg, Wwg, Uh, Ur, Wwf, Wwf, Wwg, Wwg, Wwg
Mm, Mm, Mm, Xu, Xu, Xu, Xu, Uh, Xu, Xu, Uu, Ur, Uu^Uf, Xu, Uu^Uf, Ur, Uu, Xu, Xu, Wwg, Wwg, Wwg, Ur, Ur, Uu, Ur, Uh, Ur, Ur, Xu, Wwg, Uu, Ur, Uu^Uf, Xu, Wwg, Xu, Xu
Hh, Mm, Hh, Mm, Mm, Xu, Xu, Xu, Cud, Xu, Uu, Ur, Ur, Uu, Ur, Ur, Uu^Uf, Uh, Uu^Uf, Xu, Ur, Wwf^Es, Wwg, Xu, Uu^Uf, Ur, Uh^Em, Uu, Xu, Ur, Ur, Wwf, Wwf, Xu, Wwg, Wwg, Xu, Xu
Gll, Hh, Gll, Hh, Mm, Mm, Cud, Cud, Mm, Mm, Ur, Ur, Uu, Ur, Uu, Ur, Ur, Uu, Ur, Ur, Ur, Xu, Wwg, Xu, Xu, Ur, Uh, Uu, Xu, Xu, Wwf, Wwf, Ur, Wwf, Xu, Xu, Xu, Xu
Gll^Fdf, Gll, Gll, Hh, Mm, Mm, Cud, Mm, Mm, Mm, Mm, Mm, Xu, Uu, Uu, Uh^Es, Xu, Ur, Uu, Uh, Uu^Uf, Xu, Wwg, Xu, Wwg^Es, Ur, Ur, Ur, Xu, Wwf, Uh, Uu^Uf, Ur, Wwf, Uu^Uf, Xu, Xu, Xu
Gll^Fmf, Gll^Fdf, Gll, Hh, Hh, Hh, Cud, 1 Kud, Mm, Mm, Cud, Cud, Xu, Uu, Uue, Uu, Xu, Ur, Ur, Uu, Wwg, Wwf, Uh, Wwg, Uu^Uf, Wwf, Wwg, Xu, Wwg, Wwf, Ur, Uu, Uu, Ur, Uu, Uu, Uu^Uf, Uu^Uf
Gll^Fmf, Gll^Fmf, Gll, Hh, Hh, Hh, Hh, Cud, Cud, Cud, Xu, Xu, Uue, Uue, Uue, Uue, Xu, Uu, Wwf, Wwg, Uu, Ur, Ur, Wwg, Uh, Ur, Uu^Vu, Wwg, Uh, Uu, Uu, Ur, Uh, Ur, Uh, Uh, Uh, Xu
Gll^Fmf, Gll^Fdf, Gll^Fmf, Gll, Gll, Hh, Hh, Hh, Mm, Xu, Xu, Uue, Uue, Uue, Uue, Uue, Xu, Wwg, Ur, Uu^Uf, Xu, Xu, Wwg, Wwf, Ur, Ur, Uu^Uf, Wwg, Uh, Uu^Uf, Uu, Ur, Uh, Ur, Rr, Uu^Vu, Xu, Xu
Gll^Fmf, Gll^Fmf, Gll^Fmf, Gll^Fmf, Gll^Fmf, Gll, Gll, Hh, Hh, Mm, Mm, Xu, Xu, Uue, Uue, Xu, Qxu, Wwg, Ur, Uu^Vu, Uh, Wwg, Wwf, Ur, Ur, Uu^Uf, Uu^Uf, Wwg, Uu, Uu^Uf, Ur, Ur, Rr, Rr, Cte, Rr, Uh, Xu
Gll^Fdf, Gll^Fmf, Gll^Fmf, Gll^Fdf, Gll^Fdf, Gll, Gll^Fmf, Gll, Gll, Hh, Mm, Xu, Xu, Xu, Xu, Qxu, Qxu, Wwg, Uu, Ur, Ur, Ur, Wwg, Wwg, Uu^Uf, Ur, Ur, Wwf, Wwf, Ur, Uu, Uh^Es, Rr, Cte, 3 Kte, Rr, Uu^Vu, Xu
Gll^Fdf, Gll^Fdf, Gll^Fmf, Gll^Fmf, Gll^Fmf, Gll^Fmf, Gll^Fmf, Gll, Gll, Hh, Hh, Mm, Xu, Xu, Uh, Qxu, Qxu, Wwg, Xu, Uu^Uf, Uu^Uf, Qxu, Xu, Wwg, Uh, Uh, Uu^Uf, Uh^Es, Wwg, Wwg, Uu, Uh, Rr, Cte, Rr, Rr, Uh, Xu
Gll^Fdf, Gll^Fmf, Gll^Fmf, Gll^Fmf, Gll^Fdf, Gll^Fdf, Gll^Fdf, Gll^Fmf, Gll^Fmf, Gll, Hh, Mm, Mm, Xu, Xu, Uh, Uu^Uf, Wwg, Xu, Uh, Uh, Qxu, Xu, Wwg, Xu, Xu, Xu, Xu, Wwg, Uh, Uu, Uu^Vu, Uh, Rr, Uh, Rr, Rr, Xu
Gll^Fdf, Gll^Fmf, Gll^Fmf, Gll^Fdf, Gll^Fmf, Gll^Fdf, Gll^Fmf, Gll^Fmf, Gll^Fmf, Gll, Hh, Hh, Hh, Mm, Xu, Xu, Uu, Wwg, Uu, Uu, Uh, Xu, Xu, Wwg, Xu, Xu, Xu, Xu, Wwg, Xu, Uu, Xu, Xu, Xu, Xu, Xu, Xu, Rr
