Ww, Gg^Fdf, Gg^Fdf, Gg^Fdf, Gg^Fdf, Gg^Fdf, Gg^Fdf, Gg^Fdf, Gg^Fdf, Ww, Ww, Ww, Ww, Ww, Ww, Ww, Ww, Ww, Ww, Ww, Ww, Ww, Gg^Fdf, Gg^Fdf, Gg^Fdf, Gg^Fdf, Gg^Fdf, Gg^Fdf, Gg^Fdf, Gg^Fdf, Gg^Fdf, Gg^Fdf, Gg^Fdf, Gg^Fdf, Gg^Fdf, Gg^Fdf, Gg^Fmf, Gg^Fdf, Gg^Fmf, Gg^Fmf, Gg^Fmf, Gg^Fmf, Gg^Fdf, Gg^Fmf, Gg^Fmf, Gg^Fdf
Wo, Ww, Ww, Gg^Fdf, Gg^Fdf, Gg^Fdf, Ss, Ss, Gg^Fdf, Ww, Ww, Ww, Ww, Ww, Ww, Ww, Ww, Ww, Ww, Ww, Ww, Ww, Gg^Fdf, Gg^Fdf, Gg^Fdf, Gg^Fdf, Gg^Fdf, Gg^Fdf, Gg^Fdf, Gg^Fdf, Gg^Fdf, Gg^Fdf, Gg^Fdf, Gg^Fdf, Gg^Fdf, Gg^Fmf, Gg^Fdf, Gg^Fdf, Gg^Fdf, Gg^Fmf, Gg^Ve, Gg^Fmf, Gg^Fmf, Gg^Fdf, Gg^Fmf, Gg^Fmf
Ww, Wo, Wo, Ww, Gg^Fmf, Gg^Fdf, Ss, Gg^Fdf, Gg^Fdf, Gg^Fdf, Ss, Ww, Ss, Ww, Ww, Ww, Gg^Fmf, Gg^Fdf, Gg^Fdf, Gg^Fdf, Gg^Fdf, Gg^Fdf, Gg^Fdf, Gg^Fdf, Gg^Fdf, Gg^Ve, Gg^Fdf, Gg^Fdf, Gg^Fdf, Gg^Fmf, Gg^Fmf, Gg^Fdf, Gg^Fdf, Gg^Fet, Gg^Fmf, Gg^Fdf, Gg^Fmf, Gg^Fdf, Gg^Fdf, Gg^Fdf, Gg^Fdf, Gg^Fdf, Gg^Fmf, Gg^Fmf, Gg^Fmf, Gg^Fmf
Gg^Fdf, Ww, Ww, Ww, Ww, Gg^Fdf, Gg^Fdf, Ss, Ss, Gg^Fdf, Ss, Ss, Gg^Fdf, Ss, Gg^Fmf, Gg^Fdw, Gg^Fmf, Gg^Fdf, Gg^Fdf, Gg^Fdf, Gg^Fdf, Gg^Fdf, Gg^Fdf, Gg^Fdf, Gg^Fdf, Gg^Fdf, Gg^Fdf, Gg^Fdf, Gg^Fdf, Gg^Fdf, Gg^Fmf, Gg^Fmf, Gg^Fmf, Gg^Fdf, Cv, Gg^Fet, 4 Kv, Gg^Fmf, Gg^Fdf, Gg^Fdf, Gg^Fdf, Gg^Fdf, Gg^Fdf, Gg^Fmf, Gg^Fdf, Gg^Fmf
Gg^Fdf, Ww, Ww, Wo, Ww, Gg^Fdf, Gg^Fdf, Gg^Fdf, Gg^Fdf, Ss, Ss, Ss, Gg^Fdf, Ss, Ss, Gg^Fdf, Gg^Fdf, Gg^Fdf, Gg^Fdf, Gg^Fdf, Gg^Eff, Gg^Eff, Gg^Edb, Gg^Eff, Gg^Eff, Gg^Fdf, Gg^Fdf, Gg^Fdf, Gg^Fdf, Gg^Fdf, Gg^Fdf, Gg^Fdf, Gg^Fdf, Gg^Fet, Gg^Fmf, Cv, Gg^Fdf, Cv, Cv, Gg^Fet, Gg^Fmf, Gg^Fmf, Gg^Fdf, Gg^Fmf, Gg^Fdf, Gg^Fdf
Gg^Fdf, Gg^Fmf, Ww, Wo, Wo, Ww, Gg^Fp, Gg^Fdf, Ss, Ss, Ss, Ss, Gg^Fdf, Gg^Fdf, Gg^Fdf, Gg^Fdf, Gg^Fdf, Gg^Fdf, Gg^Fdf, Gg^Fdf, Gg^Fdf, Rb^Edb, Rb^Edb, Rb, Gg^Fdf, Gg^Fdf, Gg^Fdf, Gg^Fdf, Gg^Fdf, Gg^Fdf, Gg^Fdf, Gg^Fdf, Gg^Fdf, Gg^Fmf, Gg^Fdf, Gg^Fmf, Gg^Fdf, Gg^Fmf, Gg^Fmf, Gg^Fdf, Gg^Fmf, Gg^Fdf, Gg^Fdf, Gg^Fdf, Gg^Fdf, Gg^Fdf
Gg^Fdf, Gg^Fdf, Ww, Ww, Wo, Ww, Gg^Fmf, Gg^Fmf, Gg^Fdf, Ss, Ss, Ss, Gg^Fdf, Gg^Fdf, Gg^Ve, Gg^Fdf, Gg^Fdf, Gg^Fdf, Gg^Eff, Gg^Eff, Gg^Edb, Rb, Rb^Edb, Gg^Fdf, Gg^Fdf, Gg^Fdf, Gg^Fdf, Gg^Fdf, Gg^Fdf, Gg^Fdf, Gg^Fdf, Gg^Fdf, Gg^Fdf, Gg^Fdf, Gg^Fdf, Gg^Fdf, Gg^Fdf, Gg^Fet, Gg^Fdf, Gg^Fmf, Gg^Fet, Gg^Fmf, Gg^Fdf, Gg^Fdf, Gg^Fdf, Gg^Fdf
Gg^Fdf, Gg^Fdf, Gg^Fmf, Ww, Wo, Ww, Gg^Fmf, Gg^Fdf, Gg^Fdf, Ss, Ss, Ss, Ss, Gg^Fmf, Gg^Fmf, Gg^Fmf, Gg^Fdf, Gg^Fdf, Gg^Eff, Rb, Rb^Edb, Rb, Gg^Eff, Gg^Eff, Gg^Fdf, Gg^Fdf, Gg^Fdf, Gg^Fdf, Gg^Ve, Gg^Fdf, Gg^Fdf, Gg^Fdf, Gg^Fdf, Gg^Fdf, Gg^Fdf, Gg^Fdf, Gg^Fdf, Gs^Fdf, Gg^Fdf, Gg^Fdf, Gg^Fdf, Gg^Fdf, Gg^Fdf, Gg^Ve, Gg^Fdf, Gg^Fdf
Gg^Fmf, Gg^Fmf, Gg^Fmf, Ww, Wo, Ww, Ww, Gg^Fmf, Gg^Fdf, Ss, Ss, Ss, Ss, Ss, Ss, Gg^Fmf, Gg^Fdf, Gg^Fdf, Gg^Fdf, Gg^Eff, Gg^Fdf, Gg^Fdf, Gg^Fdf, Gg^Fdf, Gg^Fdf, Gll, Gll, Gg^Fdf, Gg^Fdf, Gg^Fdf, Gg^Fdf, Gg^Fdf, Gg^Fdf, Gg^Fdf, Gg^Em, Gg^Fdf, Gs^Fdf, Gg^Fdf, Gs^Fdf, Gg^Fdf, Gg^Fdf, Gg^Fdf, Gg^Fdf, Gg^Fdf, Gg^Fdf, Gg^Fdf
Ss, Ss, Gg^Fmf, Ww, Ww, Wo, Ww, Gg^Fdf, Gg^Fdf, Gg^Fmf, Ss, Ss, Ss, Ss, Ss^Fdf, Ss, Gg^Fdf, Gg^Fdf, Gg^Fdf, Gg^Fdf, Gg^Fdf, Gg^Fdf, Gg^Fdf, Gg^Fdf, Gg^Fdf, Gg^Fdf, Gg^Fdf, Gll, Gg^Fdf, Gg^Fdf, Gg^Fdf, Gg^Fdf, Gg^Fdf, Gg^Fdf, Gg^Em, Gg^Em, Gg, Gg^Em, Gg^Em, Gg^Em, Gg^Fdf, Gg^Fdf, Gg^Fdf, Gg^Fdf, Gg^Fdf, Gg^Fdf
Ss, Ss, Gg^Fmf, Gg^Fdf, Ww, Wo, Ww, Gg^Fp, Gg^Fdf, Gg^Fmf, Gg^Fdf, Ss, Ss, Ss, Ss^Fdf, Ss, Gg^Fdf, Gg^Fdf, Gg^Fdf, Gg^Fdf, Gg^Fdf, Gg^Fdf, Gg^Fdf, Gg^Fdf, Gg^Fdf, Gg^Fdf, Gg^Fdf, Gll, Gll, Gg^Fdf, Gg^Fdf, Gg^Fdf, Gg^Fdf, Gg^Em, Gg^Em, Gg, Gg^Fetd, Gg^Efm, Gg^Em, Gg^Fdf, Gg^Fdf, Gg^Fdf, Gg^Fdf, Gg^Fdf, Gg^Fdf, Gg^Fdf
Ss, Gg^Fmf, Gg^Fmf, Gg^Fdf, Ww, Ww, Ww, Gg^Fp, Gg^Fdf, Gg^Fdf, Gg^Fmf, Ss, Ss, Ss, Gg^Fdf, Gg^Fdf, Gg^Fdf, Gg^Fdf, Ss, Gg^Fdf, Ss, Gg^Fmf, Ss, Gg^Fdf, Gg^Fmf, Gg^Fdf, Gg^Fdf, Gg^Fdf, Gg^Fdf, Gg^Fmf, Gg^Fdf, Gg^Fdf, Gg^Fdf, Gg^Em, Gg^Em, Gg^Efm, Gg^Efm, Gg, Gs^Fdf, Gg^Fdf, Gg^Em, Gg^Ve, Gg^Fdf, Gg^Fdf, Gg^Fdf, Gg^Fdf
Gg^Fmf, Ss, Gg^Fdf, Gg^Fp, Ww, Wo, Ww, Gg^Fdf, Gg^Fdf, Gg^Fdf, Gg^Fdf, Ss, Ss, Ss, Gg^Fdf, Gg^Fdf, Gg^Fdf, Gg^Fdf, Gg^Fdf, Ss, Gg^Fdf, Ss, Ss, Ss, Gg^Fdf, Gg^Fdf, Gg^Fdf, Gg^Fdf, Gg^Fdf, Gll, Gll, Gg^Fdf, Gg^Fdf, Gg^Fdf, Gg^Fdf, Gg^Em, Rp, Gg^Em, Gg^Fdf, Gg^Fdf, Gg^Fdf, Gg^Fdf, Gg^Fdf, Gg^Fdf, Gg^Fdf, Gg^Fdf
Gg^Fmf, Gg^Fmf, Gg^Fdf, Gg^Fdf, Ww, Wo, Wo, Ww, Gg^Fdf, Gg^Fdf, Gg^Fdf, Ss, Gg^Fdf, Gg^Fdf, Gg^Fdf, Gg^Fdf, Gg^Fdf, Gg^Fdf, Gg^Fdf, Gg^Fdf, Gg^Fdf, Gg^Fmf, Gg^Fmf, Ss, Gg^Fdf, Gg^Fdf, Gg^Fdf, Gg^Fdf, Gg^Fdf, Gg^Fdf, Gll, Gg^Fdf, Cv, Cvr^Fdf, Cvr^Fdf, Gg^Fdf, Rp, Gg^Fdf, Cvr^Fdf, Gg^Fdf, Gg^Fdf, Gg^Fdf, Gg^Fdf, Gg^Fdf, Gg^Fdf, Gg^Fdf
Ss, Gg^Fmf, Gg^Fdf, Gg^Fdf, Gg^Fdf, Ww, Wo, Ww, Gg^Fdf, Gg^Fdf, Gg^Fdf, Gg^Fdf, Gg^Fdf, Gg^Fdf, Gg^Ve, Gg^Fdf, Gg^Fdf, Gg^Fdf, Gg^Fdf, Gg^Fdf, Gg^Ve, Gg^Fdf, Gg^Fdf, Gg^Fdf, Gg^Fdf, Gg^Fdf, Gg^Fdf, Gg^Fdf, Gg^Fdf, Gg^Fdf, Cvr^Fdf, 3 Kvr, Ww^Bs\, Ww^Ewl, Gs^Fdf, Cv, Rp, Gs^Fdf, Cvr^Fdf, Gg^Fdf, Gg^Fdf, Gg^Fmf, Gg^Fmf, Gg^Fmf, Gg^Fdf, Gg^Fdf
Ss, Gg^Fmf, Gg^Fmf, Gg^Fdf, Gg^Fdf, Ww, Wo, Ww, Ww, Gg^Fdf, Gg^Fdf, Gg^Fdf, Gg^Fdf, Gg^Fdf, Gg^Fdf, Gg^Fdf, Gg^Fdf, Gg^Fdf, Gg^Fdf, Gg^Fdf, Gg^Fdf, Gg^Fdf, Gg^Fdf, Gg^Fdf, Gg^Fdf, Gg^Fdf, Gg^Fdf, Gg^Fdf, Gg^Fdf, Cvr^Fdf, Ww^Ewf, Ww^Ewf, Rp, Rp, Rp, Rp, Ww^Ewl, Ww^Ewf, Cvr^Fdf, Gg^Fdf, Gg^Fdf, Gg^Fdf, Gg^Fmf, Gg^Fmf, Gg^Fmf, Gg^Fdf
Ss, Ss, Gg^Fmf, Gg^Fdf, Gg^Fdf, Ww, Ww, Wo, Wo, Ww, Gg^Fdf, Gg^Fdf, Gg^Fdf, Gg^Fdf, Gg^Fdf, Gg^Fdf, Gg^Fdf, Gg^Fdf, Gg^Fdf, Gg^Fdf, Gg^Fdf, Gg^Fdf, Gg^Fdf, Gg^Fdf, Gg^Fdf, Gg^Fdf, Gg^Fdf, Gg^Fdf, Gg^Fdf, Cvr^Fdf, Gg, Rp, Cvr, Gg, Ww^Ewl, Ww^Bs\, Kvr, Cvr, Gg^Fdf, Gg^Fdf, Gg^Fdf, Gg^Fmf, Gg^Fdf, Gg^Fdf, Gg^Fdf, Gg^Fdf
Ss, Ss, Ss, Gg^Fdf, Gg^Fdf, Gg^Fdf, Gg^Fdf, Ww, Wo, Ww, Ww, Gg^Fdf, Gg^Fdf, Gg^Fdf, Gg^Fdf, Gg^Fdf, Gg^Fdf, Gg^Fdf, Cv, Gg^Fdf, Gg^Fdf, Gg^Fdf, Gg^Fdf, Gg^Fdf, Gg^Fdf, Gg^Fdf, Gg^Fdf, Gg^Fdf, Gg^Fdf, Cvr, Gg, Rp, Gg, Cvr, Cvr^Fdf, Cvr, Gg^Fdf, Gg^Fdf, Gg^Fdf, Gg^Fdf, Gg^Fdf, Gg^Fdf, Gg^Fdf, Gg^Fdf, Ww, Ww
Gg^Fdf, Ss, Ss, Gg^Fdf, Gg^Fmf, Gg^Fdf, Gg^Fdf, Ww, Ww, Wo, Ww, Ww, Gg^Fdf, Gg^Fdf, Gg^Fdf, Gg^Fdf, Cv, Cv, Cv, Gg, Gg^Fdf, Gg^Fdf, Gg^Fdf, Gg^Ve, Gg^Fdf, Gg^Fdf, Gg^Fdf, Gg^Fdf, Gg^Fdf, Gg^Fdf, Rp, Rp, Gg^Fdf, Gg^Fdf, Gg^Fdf, Gg^Fdf, Gg^Fdf, Gg^Fdf, Gg^Fdf, Gg^Fdf, Gg^Ve, Gg^Fdf, Gg^Fdf, Gg^Fdf, Ww, Gg^Fdf
Gg^Fdf, Ss, Ss^Fmf, Ss, Gg^Fmf, Gg^Fdf, Gg^Fdf, Gg^Fdf, Gg^Fdf, Ww, Wo, Ww, Ww, Gg^Fdf, Gg^Fmf, Cv, Cv, 2 Kv, Cv, Gg^Fdf, Gg^Fdf, Gg^Fdf, Gg^Fdf, Gg^Fdf, Rp, Gg^Fdf, Rp, Rp, Rp, Rp, Gg^Fdf, Gg^Fdf, Gg^Fdf, Gg^Fdf, Gg^Fdf, Gg^Fdf, Gg^Fdf, Gg^Fdf, Gg^Fp, Gg^Fdf, Gg^Fmf, Gg^Fdf, Gg^Fdf, Ww, Gg^Fp, Gg^Fdf
Ss, Ss, Ss, Ss, Gg^Fmf, Gg^Fdf, Gg^Fmf, Gg^Fmf, Gg^Fmf, Ww, Ww, Wo, Wo, Ww, Ww, Ww, Ww, Cv, Cv, Gs^Fdf, Gg^Fdf, Gg^Fdf, Rp, Rp, Gg^Fdf, Rp, Gg^Fdf, Gg^Fdf, Gg^Fdf, Gg^Fdf, Gg^Fdf, Gg^Fdf, Gg^Fdf, Gg^Fdf, Gg^Fdf, Gg^Fdf, Gg^Fdf, Gg^Fdf, Gg^Fdf, Gg^Fdf, Gg^Fdf, Gg^Fmf, Gg^Fmf, Ww, Gg^Fdf, Gg^Fdf
Gg^Fdf, Ss, Ss, Gg^Fmf, Gg^Fdf, Gg^Fmf, Ss, Ss, Ss, Gg^Fmf, Gg^Fmf, Ww, Wo, Wo, Wo, Ww, Ww, Wwf, Gs^Fdf, Gs^Fdf, Rp, Rp, Gg^Fdf, Gg^Fdf, Gg^Fdf, Gg^Fdf, Gg^Fdf, Gg^Fdf, Gg^Fdf, Gg^Fdf, Gg^Ve, Gg^Fdf, Gg^Fmf, Gg^Fdf, Gg^Fdf, Gg^Fdf, Gg^Fdf, Gg^Fdf, Gg^Fdf, Gg^Fdf, Gg^Fdf, Gg^Fmf, Gg^Fdf, Ww, Gg^Fp, Gg^Fdf
Gg^Fdf, Gg^Fdf, Gg^Fdf, Gg^Fdf, Gg^Fdf, Gg^Fmf, Gg^Fmf, Gg^Fmf, Gg^Fmf, Ss, Ww, Ww, Ww, Ww, Ww, Ww, Wwr, Wwf, Ww^Bsb/, Rp, Gs^Fdf, Gs^Fdf, Gg^Fdf, Gg^Fdf, Gg^Fdf, Gg^Fdf, Gg^Fdf, Gg^Fdf, Gg^Fmf, Gg^Fdf, Gg^Fmf, Gg^Fmf, Gg^Fdf, Gg^Fdf, Gg^Fdf, Gg^Fdf, Gg^Fp, Gg^Fmf, Ww, Gg^Fdf, Ww, Gg^Fdf, Ww, Ww, Gg^Fp, Gg^Fdf
Gg^Fdf, Gg^Fmf, Gg, Gg^Fdf, Gg^Fmf, Gg^Fmf, Ss, Gg^Fmf, Gg^Fmf, Ss, Gg^Fmf, Ww, Gs^Fmf, Gg^Fdf, Gs^Fmf, Wwr, Ww^Bsb/, Ww^Bsb/, Ww, Wwr, Cv, Gg^Fdf, Gg^Fdf, Gg^Fdf, Gg^Fdf, Gg^Fdf, Gg^Fdf, Gg^Fdf, Gg^Fdf, Gg^Fmf, Gg^Fmf, Gg^Fdf, Gg^Fdf, Gg^Fdf, Gg^Fdf, Gg^Fmf, Ww, Ww, Ww^Ewf, Ww, Ww, Ww, Gg^Fdf, Gg^Fdf, Gg^Fdf, Gg^Fdf
Gg, Gg, Gg^Fdf, Gg^Fdf, Gg^Fmf, Ss, Gg^Fmf, Gg^Fmf, Gg^Fdf, Gg^Fmf, Gs^Fmf, Gg^Fdf, Gg^Fdf, Gg^Fdf, Gll, Rp, Wwf, Wwr, Ww, Ww, Ww, Cv, Kv, Cv, Gg^Fdf, Gg^Fdf, Gg^Fdf, Gg^Fdf, Gg^Fdf, Gg^Fmf, Gg^Fdf, Gg^Fdf, Gg^Fdf, Gg^Fp, Ww, Ww, Ww, Ww, Cme, 5 Kme, Ww, Ww, Gg^Fdf, Gg^Fmf, Gg^Fmf, Gg^Fdf
Gg, Gg, Gg, Gg^Fdf, Gg^Fdf, Gg^Fmf, Gg^Fdf, Gg^Fdf, Gg^Fdf, Gg^Fdf, Gg^Fdf, Gg, Gg^Fdf, Gll, Gg^Fdf, Gs^Fmf, Gg^Fmw, Ww, Ww, Wo, Ww, Cv, Cv, Gg^Fdf, Gg^Ve, Gg^Fdf, Gg^Fdf, Gg^Fdf, Gg^Fdf, Gg^Fmf, Gg^Fmf, Gg^Fdf, Gg^Fdf, Ww, Ww, Ww^Vm, Ww, Wo, Ww, Wo, Ww, Ww, Ww^Ewf, Gg^Fdf, Gg^Fdf, Gg^Fmf
Gg, Gg, Gg^Fdf, Gg^Fdf, Gg^Fdf, Gg^Fdf, Gg^Fdf, Gg^Fdf, Gg^Fmf, Gg^Fdf, Gg, Gg^Fmf, 1 Gll, Gll, Gg^Fmf, Gg^Fdf, Gg^Fmf, Gg^Fp, Ww, Ww, Ww, Ww, Cv, Gg^Fdf, Gg^Fdf, Gg^Fdf, Gg^Fdf, Gg^Fdf, Gg^Fdf, Gg^Fdf, Gg^Fdf, Gg^Fdf, Gg^Fdf, Ss, Ss, Ww, Ww, Ww, Ww, Ww, Gg^Fdf, Ww, Ww^Ewl, Gg^Fdf, Gg^Fmf, Gg^Fmf
Gg, Gg, Gg^Fdf, Gg^Fdf, Gg^Fmf, Gg^Fmf, Gg^Fdf, Gg^Fdf, Gg^Fdf, Gg^Fdf, Gll, Gll, Gg^Fdf, Gg, Gg^Fdf, Gg^Fdf, Gg^Fmf, Gg^Fdf, Ww, Wo, Wo, Ww, Gg^Fdf, Gg^Fdf, Gg^Fdf, Gg^Fdf, Gg^Fdf, Gg^Fdf, Gg^Fdf, Gg^Fdf, Gg^Fdf, Gg^Fdf, Ss, Gg^Fdf, Ss, Ww, Ss, Gg^Fdf, Gg^Fdf, Gg^Fdf, Gg^Fdf, Ww, Gg^Fdf, Gg^Fdf, Gg^Fmf, Gg^Fmf
Gg^Fdf, Gg^Fdf, Gg^Fdf, Gg^Fdf, Gg^Fdf, Gg^Fdf, Gll, Gg^Fdf, Gll, Gll, Gg^Fdf, Gg^Fdf, Gg^Fdf, Gg^Fmf, Gg^Fdf, Gg^Fdf, Gg^Fdf, Wwt, Ww, Wo, Ww, Ww, Gg^Fmf, Gg^Fdf, Gg^Fdf, Gg^Fdf, Gg^Fmf, Gg^Fdf, Gg^Fmf, Gg^Ve, Gg^Fdf, Ss, Gg^Fdf, Ss, Gg^Fdf, Ss, Gg^Fdf, Gg^Fdf, Gg^Fdf, Gg^Fdf, Ww, Gg^Fdf, Gg^Fdf, Gg^Fdf, Gg^Fmf, Gg^Fdf
Gg^Fdf, Gg^Fdf, Gll, Gg^Fdf, Gll, Gll, Gg^Fdf, Gll, Gg^Fdf, Gg^Fdf, Gg^Fmf, Gg^Fdf, Gg^Fdf, Gg^Fdf, Gg^Fdf, Gg^Fdf, Gg^Fdf, Wwt, Ww, Wo, Ww, Gg^Fmf, Ss, Gg^Fmf, Gg^Fmf, Gg^Fmf, Ss, Gg^Fp, Ss, Gg^Fmf, Gg^Fmf, Ss, Gg^Fmf, Gg^Fdf, Gg^Fdf, Gg^Fdf, Gg^Fdf, Gg^Fdf, Ww, Ww, Ww^Vm, Ww, Gg^Fdf, Gg^Fdf, Gg^Fdf, Gg^Fmf
Gll, Gll, Gg^Fdf, Gll, Gg^Fdf, Gg^Fdf, Gg^Fdf, Gg^Fdf, Gg^Fdf, Gg^Fdf, Gg^Fdf, Gg^Ve, Gg^Fdf, Ss, Ss, Ss, Gg^Fp, Gg^Fdf, Ww, Wo, Wo, Ww, Gg^Fmf, Ss, Ss, Ss, Ss, Ss, Ss, Gg^Fp, Gg^Fmf, Ss, Gg^Fdf, Gg^Fdf, Gg^Ve, Gg^Fdf, Gg^Fdf, Ww, Ww^Ewl, Ww, Ss, Ss, Ss, Ss, Gg^Fmf, Gg^Fdf
Gg^Fdf, Gg^Fdf, Gg^Fdf, Gg^Fmf, Gg^Fmf, Gg^Fdf, Gg^Fdf, Gg^Fdf, Gg^Fdf, Gg^Fdf, Gg, Gg^Fdf, Gg^Fdf, Gg^Fdf, Ss, Gg^Fdf, Gg^Fdf, Gg^Fp, Ww, Ww, Wo, Ww, Gg^Fdf, Gg^Fdf, Gg^Fmf, Ss, Ss, Ss, Ss, Ss, Ss, Ss, Gg^Fmf, Gg^Fdf, Gg^Fdf, Gg^Fdf, Gg^Fdf, Ww, Ww, Ww, Ss, Gg^Fmf, Gg^Fp, Gg^Fmf, Gg^Fmf, Gg^Fdf
Gg, Gg, Gg, Gg^Fdf, Gg^Fdf, Gg^Fdf, Gg, Gg, Gs^Fmf, Gg, Gg^Fdf, Gg^Fdf, Gg^Fdf, Gg^Fdf, Ss, Gg^Fdf, Gg^Fdf, Gg^Fmf, Ww, Ww, Wo, Ww, Ss, Gg^Fdf, Gg^Fmf, Ss, Gg^Fp, Ss, Gg^Fmf, Ss, Gg^Fmf, Gg^Fmf, Gg^Fmf, Gg^Fdf, Gg^Fdf, Gg^Fdf, Gg^Fdf, Gg^Fdf, Ww, Ww, Ss, Gg^Fmf, Gg^Fmf, Gs^Fdf, Gs^Fdf, Gg^Fdf
Gg, Gg, Gg^Fdf, Gg^Fdf, Gg^Fdf, Gg^Fdf, Gg, Gg, Gg^Fdf, Gg^Fdf, Gg^Fdf, Gg^Fdf, Ss, Ss, Ss, Gg^Fdf, Gg^Fdf, Ww, Wo, Wo, Ww, Ww, Gg^Fdf, Gg^Fdf, Gg^Fdf, Gg^Fdf, Gg^Fdf, Gg^Fp, Gg^Fdf, Gg^Fdf, Gg^Fdf, Gg^Fdf, Gg^Fdf, Gg^Fdf, Gg^Fdf, Gg^Fdf, Gg^Fdf, Ww, Ww, Ww, Gg^Fmf, Ss, Gg^Fmf, Gg^Fmf, Gs^Fdf, Gs^Fdf
Gg^Fdf, Gg^Fdf, Gg^Fdf, Gg^Fdf, Gg, Gg, Gg, Gg^Fdf, Gg^Fdf, Gg^Fdf, Gg^Fdf, Ss, Gg^Fdf, Ss, Gg^Fdf, Gg^Fdf, Gg^Fdf, Ww, Wo, Ww, Gg^Fdf, Gg^Fdf, Gg^Fdf, Gg^Fdf, Gg^Fdf, Gg^Fdf, Gg^Fdf, Gg^Fdf, Gg^Fdf, Gg^Fdf, Gg^Fdf, Gg^Fdf, Gg^Fdf, Gg^Fdf, Gg^Fdf, Gg^Fdf, Gg^Fdf, Ww, Ww, Ww, Gg^Fmf, Gg^Fmf, Gg^Fmf, Gg^Fmf, Gs^Fdf, Gs^Fdf
