Xu, Xu, Xu, Xu, Xu, Xu, Xu, Xu, Xu, Xu, Xu, Xu, Xu, Xu, Xu, Xu, Xu, Xu, Xu, Qxu, Qxu, Qxu, Xu, Xu, Xu, Xu, Xu, Xu, Xu, Xu, Xu, Xu, Xu, Xu, Xu, Xu, Xu, Uu
Wog, Xu, Xu, Xu, Wo, Xu, Xu, Xu, Wo, Xu, Wwg, Xu, Wwg, Xu, Uu, Xu, Uh, Xu, Qxu, Qxu, Qxu, Qxu, Qxu, Xu, Xu, Xu, Xu, Xu, Xu, Xu, Urb^Ebn, Xu, Xu, Xu, Uh, Xu, Uu, Uu
Wog, Wog, Wog, Wo, Wo, Wo, Wo, Wo, Wwrg, Wwg, Wwg, Wwg, 4 Kme, Wwg, Uu, Uh, Xu, Qxu, Qxu, Qxu, Qxu, Qxu, Xu, Qxu, Qxu, Qxu, Qxu, Xu, Urb, Urb, Urb, Urb, Urb, Uh, Uu^Vu, Uu, Xu, Xu
Wog, Wog, Wo, Wo, Wwrg, Wwrg, Wwrg, Wwg^Vm, Wwg, Wwg, Wwg, Cme, Wwg, Wwg, Xu, Xu, Qxu, Xu, Xu, Xu, Xu, Xu, Xu, Xu, Xu, Qxu, Xu, Uu^Vu, Urb, Urb, Cud, Cud, Cud, Urb, Xu, Xu, Xu, Xu
Wog, Wog, Wo, Wo, Wwg, Wwrg, Wwg, Wwg, Wwg, Wwg, Wwg, Wwg, Wwg, Xu, Xu, Xu, Qxu, Qxu, Qxu, Xu, Xu, Xu, Xu, Xu, Uh, Xu, Xu, Xu, Urb, Urb, Cud, 2 Kud, Cud, Urb, Urb, Xu, Xu, Xu
Xu, Xu, Xu, Wwg, Wwg, Wwg, Wwg, Wwrg, Wwg, Wwg, Wwrg, Wwg, Wwg, Wwg, Xu, Xu, Qxu, Qxu, Qxu, Uu^Vu, Uh, Xu, Xu, Qxu, Qxu, Uh, Uu, Uu, Urb, Urb, Urb, Cud, Urb, Urb, Urb, Xu, Xu, Xu
Xu, Xu, Uu^Uf, Wwg, Wwg, Wwrg, Wwg, Wwg, Wwrg, Wwg, Wwg, Wwg, Wwg, Wwg, Xu, Xu, Xu, Qxu, Uu, Ur, Uu, Uh, Xu, Qxu, Uu, Qxu, Qxu^Bs/, Ur, Ur, Urb, Urb, Urb, Urb^Ebn, Urb, Uu^Vu, Xu, Xu, Xu
Xu, Xu, Wwg, Wwg, Wwrg, Wwg, Wwg, Wwg, Wwg, Wwg, Wwg, Wwrg, Wog, Wog, Xu, Xu, Qxu, Uu^Uf, Ur, Uu^Uf, Uu, Ur, Ur, Ur, Uu^Uf, Ur, Ur, Qxu^Bs/, Qxu, Uu^Vu, Uu^Uf, Xu, Xu, Xu, Qxu, Qxu, Xu, Xu
Xu, Xu, Wwrg, Wwg, Wwg, Wwg, Wwg, Wwg, Wwrg, Wwg, Wwg, Wog, Wog, Wog, Xu, Qxu, Qxu, Uu, Uu, Uu, Ur, Ur, Uu^Uf, Ur, Ur, Ur, Uu^Uf, Uu, Qxu, Xu, Uu^Uf, Uu^Uf, Uu^Uf, Xu, Qxu, Qxu, Xu, Xu
Xu, Wwg, Wwg, Wwg, Xu, Wwg, Wwg, Wwrg, Wwg, Wwg, Wwg, Wog, Xu, Wog, Wog, Xu, Uh, Qxu, Ur, Ur, Uu^Vu, Ur, Uh, Uh, Ur, Ur, Ur, Uu, Qxu, Xu, Uu^Uf, Uu^Uf, Xu, Xu, Xu, Qxu, Xu, Xu
Xu, Wwg, Wwg, Xu, Uu^Uf, Wwg, Wwg, Wwg, Xu, Xu, Xu, Xu, Xu, Xu, Xu, Wog, Wwg, Ur, Uu, Uu, Qxu, Qxu, Qxu, Ur, Uu^Uf, Uu, Ur, Uu, Uu^Uf, Xu, Wog, Wog, Wog, Xu, Qxu, Qxu, Qxu, Qxu
Xu, Wwrg, Wwg, Xu, Uu, Wwg, Wwg, Uu^Uf, Qxu, Qxu, Qxu, Uu^Uf, Qxu, Qxu, Qxu, Xu, Ur, Wwf, Wwf, Ur, Ur, Qxu, Ur, Ur, Uu, Uu, Ur, Uu, Xu, Xu, Wog, Wog, Wog, Xu, Qxu, Qxu, Qxu, Qxu
Xu, Wwg, Ur, Uh, Ur, Ur, Wwg, Uu, Uh, Qxu, Xu, Qxu, Xu, Qxu, Xu, Uu, Ur, Ur, Uu, Wwf, Uu, Uu, Ur, Uu^Uf, Uu, Ur, Uu^Vu, Uu^Uf, Xu, Uh, Wog, Wog, Wog, Xu, Xu, Qxu, Xu, Xu
Xu, Ur, Uu, Uu, Uu, Uh, Xu, Wwg, Wog, Xu, Xu, Xu, Xu, Xu, Uu^Uf, Uh, Uu, Uu^Vu, Uu, Wwf, Wwf, Wwg, Wwg, Uu, Wwf, Ur, Ur, Uu, Xu, Uu, Wog, Wog, Wog, Xu, Qxu, Qxu, Xu, Xu
Xu, Xu, Uu, Ur, Uu^Vu, Xu, Xu, Xu, Wog, Xu, Xu, Xu, Uh, Uh, Uu, Uu, Ur, Uu, Ur, Uu, Uh, Uu^Uf, Xu, Wwg, Wog, Wwf, Wwf, Uu, Xu, Uu^Uf, Wog, Wog, Wog, Xu, Qxu, Xu, Xu, Xu
Xu, Xu, Uu, Ur, Uu^Uf, Xu, Xu, Xu, Xu, Wwg, Wwg, Xu, Uu, Uu, Ur, Uu, Xu, Uu^Uf, Uu, Uu, Ur, Xu, Wwg, Wog, Xu, Uu, Uu, Wwg, Wwg, Wog, Wog, Wog, Wog, Xu, Xu, Qxu, Xu, Xu
Xu, Xu, Ur, Uu, Uu^Uf, Xu, Xu, Xu, Ur, Uu, Xu, Wwf, Wwf, Ur, Uh, Xu, Xu, Xu, Ur, Uu, Uu, Wwf, Uu, Xu, Uh, Ur, Ur, Xu, Xu, Wog, Xu, Wog, Xu, Xu, Uh, Uh, Uh, Xu
Xu, Uh, Ur, Uu, Xu, Xu, Ur, Ur, Xu, Xu, Uu^Uf, Uu, Ur, Wwf, Wwg, Xu, Xu, Xu, Xu, Uu, Wwf, Wwf, Ur, Uu, Ur, Uu, Uu, Xu, Xu, Xu, Xu, Xu, Xu, Uh, Cte, 3 Kte, Uh, Xu
Xu, Uh, Uh, Uu, Uu, Uu, Xu, Xu, Xu, Xu, Xu, Uu, Ur, Uh, Xu, Wwg, Wog, Wog, Wwg, Wwf, Wwf, Wwf, Xu, Uu^Vu, Ur, Uu, Ur, Xu, Uu^Vu, Xu, Uu^Uf, Xu, Uu^Uf, Uh, Uh, Uh, Uh, Xu
Uu, Xu, Uh, Ur, Uu^Uf, Xu, Xu, Xu, Uu^Vu, Xu, Uu, Uu, Uu, Uu, Ur, Wwg, Wwg, Wog, Cte, Wwf, Wwf, Wwg, Wog, Xu, Uu, Uu, Uu, Uu, Ur, Uh, Uh, Xu, Uh, Uh, Uh, Uh, Xu, Xu
Uu, Uu, Uu, Uu, Uu^Uf, Xu, Xu, Xu, Uu^Uf, Uu, Ur, Ur, Uh, Uu, Ur, Wwf, Ur, Kte, Cte, Ur, Uu, Xu, Xu, Wwg, Wwf, Ur, Ur, Uu, Uu^Uf, Uh, Uh, Uh, Uh, Uh, Uh, Uu^Vu, Xu, Xu
Xu, Uu, Uu^Uf, Ur, Uu, Xu, Xu, Xu, Uu, Uu, Xu, Xu, Xu, Xu, Xu, Wwg, Uu, Ur, Uu^Vu, Ur, Uu, Uu^Uf, Uu, Wwf, Uu, Wwf, Wwf, Wwf, Wwf, Uh, Xu, Uh, Xu, Uu^Uf, Uh, Uh, Uu^Uf, Xu
Xu, Xu, Uu^Uf, Ur, Uh, Xu, Xu, Xu, Uh, Ur, Uu, Xu, Xu, Xu, Wog, Wog, Xu, Uu, Ur, Uu, Ur, Ur, Uu, Ur, Uu, Ur, Uu, Wwf, Xu, Wwg, Wo, Xu, Xu, Uh, Uh, Uh, Xu, Xu
Xu, Xu, Uu, Ur, Uu, Xu, Xu, Xu, Xu, Ur, Uu, Uh, Xu, Xu, Wog, Xu, Uu, Uu, Uu, Uu^Uf, Xu, Uh, Xu, Xu, Uu^Uf, Uu, Ur, Xu, Xu, Xu, Xu, Wo, Wwg, Uh, Uh, Uh, Xu, Xu
Xu, Xu, Uu^Vu, Uu, Ur, Xu, Xu, Xu, Xu, Xu, Uu, Ur, Wwg, Wog, Xu, Wwg, Wwf, Ur, Uu, Uu^Uf, Xu, Xu, Uh, Ur, Uu, Ur, Uu, Uu^Vu, Xu, Xu, Xu, Xu, Wwf, Uu, Ur, Uh, Wwg, Wwg
Xu, Xu, Xu, Uu, Ur, Uu, Uu, Xu, Xu, Xu, Wwf, Wwf, Xu, Xu, Uu^Vu, Ur, Ur, Wwf, Wwg, Xu, Xu, Xu, Uu, Uu, Ur, Xu, Uu, Uu, Xu, Xu, Xu, Uh, Ur, Wwf, Wwf, Wwg, Xu, Wwg
Xu, Xu, Xu, Xu, Xu, Uu, Uu^Uf, Ur, Wwf, Wwg, Uu^Uf, Ur, Xu, Xu, Uu^Uf, Uu, Uu, Xu, Xu, Wog, Wwg, Ur, Ur, Uu, Uu, Ur, Xu, Uh, Xu, Xu, Xu, Uu, Uu, Uu^Uf, Xu, Xu, Xu, Xu
Xu, Xu, Wog, Xu, Xu, Xu, Wwf, Wwf, Ur, Uu, Xu, Xu, Xu, Uh, Ur, Ur, Uu, Uh, Uh, Xu, Ur, Wwf, Wwg, Xu, Uu, Uu, Xu, Ur, Xu, Xu, Uh, Ur, Ur, Xu, Xu, Xu, Xu, Xu
Wog, Wog, Xu, Wog^Xo, Wog, Wwg, Xu, Uu^Uf, Uu, Uu, Xu, Xu, Uh, Uu, Uu, Uu, Uu^Uf, Uu, Ur, Uu, Uu, Xu, Wog, Xu, Xu, Ur, Xu, Ur, Xu, Xu, Uu^Uf, Uu, Uu^Uf, Xu, Xu, Xu, Xu, Xu
Xu, Xu, Xu, Xu, Xu, Xu, Xu, Uh, Ur, Uu, Xu, Xu, Uu, Ur, Uu, Ur, Ur, Uu, Xu, Uu, Uu, Xu, Wwg, Xu, Wwf, Uu, Uu, Uu, Xu, Uh, Uu, Ur, Uu, Xu, Xu, Xu, Xu, Xu
Xu, Xu, Xu, Xu, Xu, Xu, Xu, Uu^Vu, Uu, Uu^Uf, Uu, Uu, Ur, Uu, Ur, Uu, Uh, Uu, Xu, Uh, Ur, Uu, Ur, Wwg, Uu^Uf, Wwf, Wwf, Xu, Wog, Xu, Xu, Ur, Uu, Uu^Vu, Xu, Xu, Xu, Xu
Xu, Xu, Xu, Xu, Uh, Uh, Uh, Uu, Ur, Uu^Uf, Ur, Ur, Uu, Uu, Xu, Xu, Xu, Xu, Uu^Uf, Ur, Uu, Uu, Ur, Wwf, Uu, Ur, Uu, Wwg, Xu, Wog, Wog, Uu, Ur, Uu, Uu^Uf, Xu, Xu, Xu
Xu, Xu, Xu, Xu, Uh, Uh, Uu, Uu, Ur, Uu, Ur, Uu^Uf, Uh, Xu, Uu, Uu^Uf, Uu, Ur, Uu, Uu, Xu, Xu, Wwg, Wwf, Uu, Ur, Uu^Uf, Uh, Uh, Xu, Ur, Wwg, Ur, Uu, Xu, Xu, Xu, Xu
Xu, Xu, Uu, Uh, Ce, Ur, Ur, Uu, Uu, Uu, Ur, Ur, Uu, Uu, Ur, Uu, Uh, Ur, Xu, Uu^Vu, Xu, Xu, Wwg, Xu, Uu, Uu^Uf, Uu^Uf, Uu, Ur, Uu, Uu, Wwf, Wwf, Uu^Uf, Xu, Xu, Wog, Wog
Xu, Xu, Uu, Ce, 1 Ke, Ce, Uu, Uu, Uh, Xu, Xu, Uh, Uu^Vu, Ur, Xu, Xu, Xu, Xu, Xu, Xu, Xu, Wwg^Xo, Xu, Xu, Uu^Uf, Uu, Uu, Uu^Uf, Uu, Ur, Uh, Uu, Xu, Wwg, Xu, Wog, Xu, Xu
Hh, Ur, Ur, Ce, Ce, Ce, Uu, Uh, Uh, Xu, Xu, Xu, Xu, Xu, Xu, Xu, Xu, Xu, Xu, Xu, Wwg, Wwg, Xu, Xu, Uh, Uh, Uu^Uf, Uu, Uu^Vu, Uu^Uf, Xu, Xu, Xu, Wwg, Wog^Xo, Wog, Xu, Xu
Hh, Hh, Hh, Ur, Ur, Uu, Uh, Uh, Xu, Xu, Xu, Xu, Xu, Xu, Xu, Xu, Wwg, Xu, Wwg, Xu, Wwg, Xu, Xu, Xu, Xu, Xu, Xu, Xu, Xu, Xu, Xu, Xu, Xu, Xu, Xu, Xu, Xu, Xu
Hh, Hh, Hh, Hh, Xu, Xu, Xu, Xu, Xu, Xu, Xu, Xu, Xu, Xu, Xu, Wwg, Wwg, Wwg, Wwg, Wwg, Xu, Xu, Xu, Xu, Xu, Xu, Xu, Xu, Xu, Xu, Xu, Xu, Xu, Xu, Xu, Xu, Xu, Xu
