Xu, Xu, Xu, Xu, Xu, Xu, Xu, Xu, Xu, Xu, Xu, Xu, Xu, Xu, Xu, Xu, Xu, Xu, Xu, Qxu, Qxu, Qxu, Xu, Xu, Xu, Xu, Xu, Xu, Xu, Xu, Xu, Xu, Xu, Xu, Xu, Xu, Xu, Uu
Wog, Xu, Xu, Xu, Wo, Xu, Xu, Xu, Wo, Xu, Wog, Xu, Wog, Xu, Wog^Vm, Xu, Uh, Xu, Qxu, Qxu, Qxu, Qxu, Qxu, Xu, Xu, Xu, Xu, Xu, Xu, Xu, Xu, Xu, Xu, Xu, Uh, Xu, Uu, Uu
Wog, Wog, Wog, Wo, Wo, Wo, Wo, Wo, Wwrg, Wog, Wog, Wog, 4 Kme, Wog, Wog, Wwg, Xu, Qxu, Qxu, Qxu, Qxu, Qxu, Xu, Qxu, Qxu, Qxu, Qxu, Xu, Urb, Urb^Ebn, Urb, Urb, Urb, Uh, Uu^Vu, Uu, Xu, Xu
Wog, Wog, Wo, Wo, Wwrg, Wog, Wwrg, Wog, Wog, Wog, Wog, Cme, Wog, Wog, Xu, Xu, Qxu, Xu, Xu, Xu, Xu, Xu, Xu, Xu, Xu, Qxu, Xu, Uu^Vu, Urb, Urb, Cud, Urb, Cud, Urb, Xu, Xu, Xu, Xu
Wog, Wog, Wo, Wo, Wog, Wwrg, Wog, Wog, Wog, Wog, Wog, Wog, Wog, Xu, Xu, Xu, Qxu, Qxu, Qxu, Xu, Xu, Xu, Xu, Xu, Uh, Xu, Xu, Xu, Urb, Urb, Cud, 2 Kud, Urb, Urb, Urb, Xu, Xu, Xu
Xu, Xu, Xu, Wog, Wog, Wog, Wog, Wwrg, Wog, Wog, Wwrg, Wog, Wog, Wog, Xu, Xu, Qxu, Qxu, Qxu, Uu^Vu, Uh, Xu, Xu, Qxu, Qxu, Uh, Uu, Uu, Urb, Urb, Urb, Cud, Urb, Urb, Urb, Xu, Xu, Xu
Xu, Xu, Uu^Uf, Wog, Wog, Wwrg, Wog, Wog, Wwrg, Wog, Wog, Wog, Wog, Wog, Xu, Xu, Xu, Qxu, Uh, Ur, Ur, Uh, Xu, Qxu, Uu, Qxu, Qxu^Bs/, Ur, Ur, Urb, Urb, Urb, Urb^Ebn, Urb, Uu^Vu, Xu, Xu, Xu
Xu, Xu, Wwg, Wwg, Wwrg, Wog, Wog, Wog, Wog, Wog, Wog, Wwrg, Wog, Wog, Xu, Xu, Qxu, Uu^Uf, Uh, Uu^Uf, Uu, Ur, Ur, Uh, Uu^Uf, Ur, Ur, Qxu^Bs/, Qxu, Uu^Vu, Uu^Uf, Xu, Xu, Xu, Qxu, Qxu, Xu, Xu
Xu, Xu, Wwrg, Wwg, Wwg, Wwg, Wwg, Wog, Wwrg, Wog, Wog, Wog, Wog, Wog, Xu, Qxu, Qxu, Uu, Uu, Uu, Ur, Ur, Uu^Uf, Ur, Ur, Ur, Uu^Uf, Uu, Qxu, Xu, Uu^Uf, Uu^Uf, Uh, Xu, Qxu, Qxu, Xu, Xu
Xu, Wwg, Wwg, Wwg, Xu, Wwg, Wwg, Wwrg, Wwg, Wog, Wog, Wog, Xu, Wwg, Wwg, Xu, Uh, Qxu, Ur, Ur, Uu^Vu, Uu^Uf, Uh, Uh, Ur, Ur, Ur, Uu, Qxu, Xu, Uu^Uf, Uu^Uf, Xu, Xu, Xu, Qxu, Xu, Xu
Xu, Wwg, Wwg, Xu, Uu^Uf, Wwg, Wwg, Wwg, Xu, Xu, Xu, Xu, Xu, Xu, Xu, Wwg, Wwg, Ur, Uu, Uu, Qxu, Qxu, Qxu, Ur, Uu^Uf, Uh, Uh, Ur, Uu^Uf, Xu, Wog, Wog, Wog, Xu, Qxu, Qxu, Qxu, Qxu
Xu, Wwrg, Wwg, Xu, Uu, Wwg, Wwg, Uu^Uf, Qxu, Qxu, Qxu, Uu^Uf, Qxu, Qxu, Qxu, Xu, Uu^Uf, Wwf, Wwg, Uu, Uu^Uf, Qxu, Ur, Ur, Ur, Uh, Uu^Uf, Ur, Xu, Xu, Wog, Wog, Wog, Xu, Qxu, Qxu, Qxu, Qxu
Xu, Wwg, Ur, Uh, Ur, Ur, Wwg, Uu, Uh, Qxu, Xu, Qxu, Xu, Qxu, Xu, Uu^Uf, Uu, Ur, Uu, Wwg, Uu^Uf, Uu, Ur, Uu^Uf, Uh, Ur, Ur^Vu, Ur, Xu, Uh, Wog, Wog, Wog, Xu, Xu, Qxu, Xu, Xu
Xu, Uu, Uu, Ur, Uu, Uh, Xu, Wwg, Wwg, Xu, Xu, Xu, Xu, Xu, Uu^Uf, Uh, Ur, Ur^Vu, Ur, Wwg, Wwf, Wwf, Wwg, Uu, Uu^Uf, Uu, Ur, Uu, Xu, Uu, Wog, Wog, Wog, Xu, Qxu, Qxu, Xu, Xu
Xu, Xu, Uu, Ur, Uu^Vu, Xu, Xu, Xu, Wwg, Xu, Xu, Xu, Uh, Uh, Ur, Ur, Uu, Uu, Uu, Ur, Uh, Uu^Uf, Xu, Wwg, Wwg, Wwg, Wwf, Uu, Xu, Uu^Uf, Wog, Wog, Wog, Xu, Qxu, Xu, Xu, Xu
Xu, Xu, Ur, Ur, Uu^Uf, Xu, Xu, Xu, Xu, Wwg, Wwf, Xu, Uu, Uu, Ur, Uu, Xu, Uu^Uf, Uu, Ur, Uu, Xu, Wwg, Wwg, Xu, Uu^Uf, Ur, Wwg, Wwg, Wog, Wog, Wog, Wog, Xu, Xu, Uh, Uh^Vu, Xu
Xu, Xu, Ur, Uu, Uu^Uf, Xu, Xu, Xu, Uu, Ur, Xu, Wwf, Wwf, Ur, Uh, Xu, Uh, Xu, Uh, Ur, Ur, Wwf, Ur, Xu, Uh, Uu, Ur, Xu, Xu, Wog, Xu, Wog, Xu, Xu, Uh, Uh, Uh, Xu
Xu, Uh, Ur, Uu, Xu, Xu, Uu, Uu, Xu, Xu, Uu^Uf, Uu, Ur, Wwg, Wwg, Xu, Uh, Uh, Xu, Uu, Wwf, Wwf, Uu, Ur, Ur, Uh, Ur, Uh, Xu, Xu, Xu, Xu, Xu, Uh, Cte, 3 Kte, Uh, Xu
Xu, Uh, Uh, Ur, Ur, Ur, Xu, Xu, Xu, Xu, Uh, Uh, Ur, Uh, Xu, Wwg, Wwg, Wwg, Wwg, Uu^Uf, Wwf, Uu^Uf, Xu, Uu^Vu, Ur, Uu, Ur, Xu, Uu^Vu, Xu, Uu^Uf, Xu, Uu^Uf, Uh, Uh, Uh, Uh, Xu
Uu, Xu, Uh, Ur, Uu^Uf, Xu, Xu, Xu, Uu^Vu, Xu, Uu, Uh, Ur, Ur, Ur, Wwg, Uu, Uu, Cte, Wwf, Uu^Uf, Wwg, Wwg, Xu, Uu, Ur, Uh, Ur, Uu, Uh, Uh, Xu, Uh, Uh, Uh, Uh, Xu, Xu
Uu, Uu, Uu, Ur, Uu^Uf, Xu, Xu, Xu, Uu^Uf, Ur, Ur, Ur, Uh, Uu, Uu, Wwf, Ur, Kte, Cte, Ur, Uu, Xu, Xu, Wwg, Wwg, Ur, Uh, Ur, Uu^Uf, Uh, Uh, Uh, Uh, Uh, Uh, Uh, Xu, Xu
Xu, Uu, Uu^Uf, Ur, Uu, Xu, Xu, Xu, Uu, Ur, Uh, Xu, Xu, Xu, Xu, Wwg, Uu, Ur, Uu^Vu, Ur, Uu, Uu^Uf, Ur, Wwg, Ur, Wwf, Wwf, Wwf, Wwg, Uh, Xu, Uh, Xu, Uu^Uf, Uh, Uh, Uu^Uf, Xu
Xu, Xu, Uu^Uf, Ur, Uh, Xu, Xu, Xu, Uh, Ur, Uu, Xu, Xu, Xu, Wwg, Wwg, Xu, Uu, Ur, Ur, Ur, Ur, Uu, Ur, Uu, Ur, Uh, Wwg, Xu, Wwg, Wwg, Xu, Xu, Uh, Uh, Uh, Xu, Xu
Xu, Xu, Uu, Ur, Uu, Xu, Xu, Xu, Xu, Ur, Ur, Uh, Xu, Xu, Wwg, Xu, Uu, Uu, Ur, Uu^Uf, Uh, Uh, Xu, Xu, Uu^Uf, Ur, Uh, Xu, Xu, Xu, Xu, Wwg, Wwg, Uh, Uh, Uh, Xu, Xu
Xu, Xu, Uu^Vu, Ur, Ur, Xu, Xu, Xu, Xu, Uu^Uf, Uu, Ur, Wwg, Wwg, Xu, Wwg, Wwf, Ur, Uu, Uu^Uf, Xu, Xu, Uh, Ur, Ur, Ur, Ur, Uu, Xu, Xu, Xu, Xu, Wwf, Ur, Uu^Vu, Uh, Wwg, Wwg
Xu, Xu, Xu, Uh, Ur, Uu, Ur, Xu, Xu, Uh, Wwg, Wwf, Uu^Uf, Xu, Uu^Vu, Uu, Ur, Wwg, Wwg, Xu, Xu, Xu, Uh, Uu, Ur, Xu, Ur, Uu^Vu, Xu, Xu, Xu, Uh, Ur, Wwf, Wwf, Wwg, Xu, Wwg
Xu, Xu, Xu, Xu, Uh, Ur, Uu^Uf, Ur, Wwf, Wwg, Ur, Ur, Xu, Xu, Uu^Uf, Ur, Uu, Xu, Xu, Wwg, Wwg, Uu, Ur, Ur, Uu, Ur, Uh, Uu^Uf, Xu, Xu, Xu, Uu, Ur, Uu^Uf, Xu, Xu, Xu, Xu
Xu, Xu, Wwg, Xu, Xu, Uh, Wwg, Wwg, Uu, Ur, Uh, Xu, Xu, Uh, Ur, Ur, Uu^Uf, Uh, Uh, Xu, Ur, Wwf, Wwg, Xu, Uu^Uf, Ur, Uh, Uu, Xu, Xu, Uh, Uu, Ur, Xu, Xu, Xu, Xu, Xu
Wwg, Wwg, Xu, Wwg, Wwg, Wwg, Xu, Uu^Uf, Uu, Ur, Xu, Xu, Uh, Uu, Ur, Uu, Uu^Uf, Uu, Ur, Ur, Uu, Xu, Wwg, Xu, Xu, Ur, Uh, Uu, Xu, Xu, Uu^Uf, Ur, Uu^Uf, Uh, Xu, Xu, Xu, Xu
Xu, Xu, Xu, Xu, Xu, Xu, Uh, Uh, Ur, Ur, Xu, Xu, Uh, Ur, Uh, Ur, Ur, Ur, Xu, Ur, Ur, Xu, Wwg, Xu, Wwg, Ur, Ur, Ur, Xu, Uh, Uu, Ur, Uu, Uh, Uh, Xu, Xu, Xu
Xu, Xu, Xu, Xu, Xu, Xu, Xu, Uu^Vu, Ur, Uu^Uf, Uu, Uu, Ur, Ur, Ur, Uu, Uh, Uu, Xu, Uh, Ur, Uh, Uu, Wwg, Uu^Uf, Wwf, Wwg, Xu, Wwg, Xu, Xu, Ur, Ur, Uu^Vu, Uh, Xu, Xu, Xu
Xu, Xu, Xu, Xu, Uh, Uu^Uf, Uh, Uu, Ur, Uu^Uf, Ur, Ur, Uu, Uu, Xu, Xu, Xu, Xu, Uu^Uf, Ur, Uu, Ur, Ur, Wwg, Uu, Ur, Uu, Wwg, Xu, Wwg, Wwg, Uu, Ur, Uu, Uu^Uf, Xu, Xu, Xu
Xu, Xu, Xu, Xu, Uh, Uh, Uu, Uu, Ur, Ur, Ur, Uu^Uf, Uh, Xu, Uu, Uu^Uf, Ur, Uu, Ur, Ur, Xu, Xu, Wwg, Wwf, Ur, Ur, Uu^Uf, Uh, Uh, Xu, Ur, Wwg, Ur, Uu, Xu, Xu, Xu, Xu
Xu, Xu, Uu^Uf, Uh, Ce, Ur, Ur, Ur, Uu, Uu, Uu, Ur, Ur, Uu, Ur, Ur, Uh, Ur, Xu, Uu^Vu, Xu, Xu, Wwg, Xu, Ur, Uu^Uf, Uu^Uf, Uu, Uu, Uu, Ur, Wwf, Wwg, Uu^Uf, Xu, Xu, Wwg, Wwg
Xu, Xu, Uu, Ce, 1 Ke, Ce, Uu, Uu, Uu^Uf, Xu, Xu, Uh, Uu^Vu, Ur, Xu, Xu, Xu, Xu, Xu, Xu, Xu, Wwg, Xu, Xu, Uu^Uf, Ur, Ur, Uu^Uf, Ur, Ur, Uh, Uu, Xu, Wwg, Xu, Wwg, Xu, Xu
Hh, Uu, Ur, Ce, Ce, Ce, Uu, Uh, Uu^Uf, Xu, Xu, Xu, Xu, Xu, Xu, Xu, Xu, Xu, Xu, Xu, Wwg, Wwg, Xu, Xu, Uh, Uh, Uu^Uf, Ur, Uu^Vu, Uu^Uf, Xu, Xu, Xu, Wwg, Wwg, Wwg, Xu, Xu
Hh, Hh, Hh, Ur, Uu, Uu, Uh, Uh, Xu, Xu, Xu, Xu, Xu, Xu, Xu, Xu, Wwg, Xu, Wwg, Xu, Wwg, Xu, Xu, Xu, Xu, Xu, Xu, Xu, Xu, Xu, Xu, Xu, Xu, Xu, Xu, Xu, Xu, Xu
Hh, Hh, Hh, Hh, Xu, Xu, Xu, Xu, Xu, Xu, Xu, Xu, Xu, Xu, Xu, Wwg, Wwg, Wwg, Wwg, Wwg, Xu, Xu, Xu, Xu, Xu, Xu, Xu, Xu, Xu, Xu, Xu, Xu, Xu, Xu, Xu, Xu, Xu, Xu
