Aa, Ms, Ms, Ms, Aa, Aa, Ms, Qxu, Qxu, Ms^Xm, Ms^Xm, Ms^Xm, Ai, Ai, Ai, Ms, Ms, Md, Ms, Ms, Aa, Ha, Ha, Ha, Ms, Ms
Ms, Ms, Aa, Aa, Ms, Ms, Ms, Qxu, Ms, Ms, Ms, Ms, Ai, Ai, Ai, Ai, Ms, Ha, Ha, Ms, Ms, Aa, Aa, Ms, Ms, Ms
Ha, Ha, Aa, Ms, Ms, Ms, Ms^Xm, Ms, Ms, Ms^Vd, Ms, Ms, Ms, Ai, Ai, Ai, Ha, Aa, Ms, Ha, Ms, Aa^Vca, Aa, Ms, Ms^Xm, Ms
Ha, Aa, Aa, Ms^Xm, Ms^Xm, Ms^Xm, Ms, Ms, Ms, Ms, Ms, Ms, Ai, Ai, Ms, Ha, Ha, Ha, Ha, Ms, Ha^Fpa, Ms^Fpa, Aa^Fpa, Ms^Xm, Ms^Xm, Ms^Xm
Aa, Aa, Ha, Ms, Cha, Ms, Mv, Ms, Cha, Ms, Ai, Ai, Ms, Ms, Ms, Ms, Ha, Ha, Ha, Ha, Aa, Aa^Fpa, Aa, Ms^Xm, Ms, Ms
Ha, Aa, Ha, Ha^Vd, Cha, Md, Md, Md, Cha, Ms, Ha, Ai, Aa, Aa, Aa^Fpa, Ms, Aa^Fpa, Aa, Ha, Aa, Aa, Ms, Ms, Aa, Aa, Ms
Aa, Aa, Ha, Ha, Md, Cha, 1 Kha, Cha, Ms, Ms, Ms, Ai, Ai, Aa, Aa, Aa^Fpa, Aa, Ha, Aa, Ms, Ha, Aa, Aa, Ms, Aa, Aa
Aa, Ha, Ms, Md, Qlf, Md, Ms, Ms, Md, Md, Md, Ms, Ai, Ha, Ai, Aa, Ai, Aa, Aa, Ms, Ms, Aa, Aa, Ms, Ms^Xm, Ms
Aa, Aa, Ms, Md, Qlf, Md, Md, Md, Md, Qlf, Hhd, Ms^Vd, Aa, Ai, Ms, Ai, Aa, Ai, Ai, Ha, Ms, Ms, Ms, Ms^Xm, Ha, Ms
Ha, Aa, Aa, Md, Md, Md, Md, Qlf, Qlf, Hhd, Ha, Aa, Aa, Aa, Ms, Ms, Ms, Ms, Ha, Ai, Ai, Ha^Vca, Ai, Aa, Ai, Ha
Aa, Ha, Ha, Aa, Aa, Ms^Vd, Ms, Md, Hhd, Hhd, Aa, Aa, Ms, Ms, Ms, Ms, Aa, Ms, Ha, Ha, Ms, Ai, Ms, Ai, Ms, Ai
Ms, Ha, Ha, Ha, Ha, Aa, Aa, Ms, Ha, Aa, Aa, Aa, Ms, Ms, Ms, Ms, Ms, Ms, Ha^Fpa, Aa, Aa, Ms, Ha, Ms, Hhd, Md
Ms^Fpa, Ha, Ha, Ha, Ha, Ha, Ha^Fpa, Aa, Aa, Aa, Ms, Aa, Aa, Ms, Md, Ms, Ms, Ms, Ha^Fpa, Ha, Ha, Ha, Hhd, Hhd, Qlf, Qlf
Ms, Ha, Aa, Aa, Aa, Ha^Fpa, Ha^Fpa, Ha, Aa, Aa, Ms, Ms, Md, Md, Qlf, Hhd, Ha, Ha^Fpa, Ha^Fpa, Ha, Ha^Vca, Ha, Hhd, Qlf, Qlf, Qlf
Ha, Ha, Aa, Ms, Aa, Ms, Rd, Ha, Ha, Aa, Ms, Ms, Md, Qlf, Qlf, Hhd, Ms, Ha, Ms, Ha, Ha, Ha, Ha, Hhd, Md, Qlf
Ha, Ha, Ha, Ms, Ms, Md, Qlf, Rd, Aa, Ha, Aa^Fpa, Ms, Ms, Md, Qlf, Md, Ms, Ms^Xm, Ms^Xm, Ms, Ms, Ms, Ms, Ms, Ms, Hhd
Ms, Aa, Ha, Aa, Ms, Md, Qlf, Md, Rd, Ha, Aa^Fpa, Ms^Fpa, Ha^Fpa, Hhd, Qlf, Hhd, Ha, Ms, Ms^Xm, Ms, Ai, Ai, Ai, Ms, Ms, Ms
Ms, Ha, Ha, Ha^Fpa, Ms^Fpa, Md, Md, Qlf, Qlf, Hhd, Ha, Ha^Fpa, Ha, Hhd, Hhd, Hhd, Aa, Ha, Ai, Ai, Ai, Ai, Ai, Ms, Ms, Ha
Ha, Aa, Ha, Aa^Fpa, Aa, Ms, Ms^Vca, Md, Md, Hhd, Hhd, Hhd, Hhd, Ha, Ha, Ha, Ha, Ha^Vca, Ai, Ai, Ai, Ai, Ai, Ms, Ms, Ha
Ms, Ha, Aa, Aa, Md, Aa, Ms, Ms, Ms, Ha, Hhd, Qlf, Hhd, Ms, Md, Md, Md, Ms, Ai, Ai, Ai, Ai, Ai, Ms, Ha^Fpa, Ha
Ms^Xm, Ms^Xm, Ms, Md, Qlf, Md, Ha, Ha, Ha, Ha, Ha, Md, Ms, Hhd, Qlf, Qlf, Qlf, Wwt, Ha^Fpa, Ha^Fpa, Ha, Ai, Aa, Ha^Fpa, Ms^Fpa, Ms^Fpa
Ms^Xm, Ms^Xm, Ms^Xm, Rd, Rd, Rd, Ha, Ha^Fpa, Ha^Fpa, Ms, Ms, Ha, Hhd, Hhd, Hhd, Qlf, Wwt, Wwt, Aa^Fpa, Aa, Ms, Aa, Ms, Ms, Ms, Aa^Fpa
Aa, Ms, Ms^Fpa, Ms^Xm, Ms, Ha, Ha, Ha^Fpa, Ha, Ms, Hhd, Hhd, Qlf, Hhd, Ai, Wwt, Md, Md, Md, Ms, Ms, Ms, Ms, Ms, Ms, Ms
Ha, Ha^Fpa, Ha, Ms, Ha, Ha^Vca, Md, Ha, Ha, Hhd, Qlf, Qlf, Hhd, Wwt, Ms^Vca, Ms, Md, Qlf, Qlf, Md, Hhd, Ms, Ms, Ms, Ms, Ms
Ha, Ha, Ha, Ha, Ms, Md, Qlf, Md, Aa, Md, Md, Qlf, Wwt, Ai, Ms, Ha, Ha, Hhd, Hhd, Qlf, Qlf, Hhd, Ms^Xm, Ms, Ms, Ms
Ha^Fpa, Ha, Ha, Ha, Ha, Md, Qlf, Md, Ha, Aa, Ai, Wwt, Aa^Fpa, Ms, Ha, Ha, Hhd, Hhd, Hhd, Hhd, Qlf, Rd, Aa^Fpa, Ms, Aa, Ms
Aa^Fpa, Ha^Fpa, Aa, Ha, Aa, Hhd, Qlf, Hhd, Ha, Aa^Fpa, Ai, Aa^Fpa, Qlf, Hhd, Hhd, Hhd, Qlf, Qlf, Qlf, Hhd, Hhd, Rd, Aa^Fpa, Aa^Fpa, Ms, Aa
Ms, Ms, Ms, Aa, Aa, Hhd, Qlf, Hhd, Md, Aa^Fpa, Wwt, Md, Qlf, Qlf, Qlf, Hhd, Aa, Qlf, Hhd, Md, Hhd, Aa, Ms, Ms, Ms, Ms
Ms, Ms, Ms, Aa, Aa, Hhd, Hhd, Qlf, Md, Ms, Wwt, Qlf, Rd, Rd, Rd, Rd, Aa, Hhd, Hhd, Qlf, Rd, Aa, Ms, Ms, Ms^Xm, Ms^Xm
Ms, Ms, Ms, Ms, Aa, Ha, Hhd, Qlf, Qlf, Hhd, Ai, Md, Ms, Aa^Vca, Md, Ms, Ms, Aa, Cea, Md, Ms, Aa, Ms, Ms^Xm, Ms^Xm, Ms^Xm
Aa, Aa^Vca, Ha, Aa, Ha^Fpa, Ha^Fpa, Ha, Hhd, Hhd, Hhd, Ai, Ms, Md, Rd, Qlf, Rd, Rd, Cea, 2 Kea, Cea, Aa, Aa^Vca, Ms, Ms^Xm, Ms^Xm, Ms^Xm
Ha, Ha, Hhd, Aa, Hhd, Ha^Fpa, Ha, Ha, Ai, Ai, Ms, Ms, Rd, Qlf, Hhd, Qlf, Rd, Cea, Cea, Cea, Ha, Aa, Ms, Ms, Ms^Xm, Ms^Xm
Rd, Hhd, Qlf, Hhd, Qlf, Hhd, Ai, Ai, Ms, Ms, Ms^Xm, Ms^Xm, Ha, Hhd, Aa^Fpa, Rd, Ms, Ms, Ha, Ha, Ms, Ms, Ms, Ms, Ms^Xm, Ms^Xm
Qlf, Qlf, Qlf, Qlf, Wwt, Wwt, Md, Md, Md^Xm, Ms^Xm, Rd, Hhd, Rd, Aa^Fpa, Ms, Ms^Vca, Hhd, Hhd, Hhd, Ha, Aa, Ms, Md, Md, Md, Ms^Xm
Hhd, Hhd, Hhd, Hhd, Ai, Ms, Md, Qlf, Qlf, Rd, Qlf, Qlf, Qlf, Md, Ha, Hhd, Qlf, Qlf, Rd, Ms, Md, Md, Qlf, Qlf, Md, Ms
Aa^Fpa, Ha^Fpa, Ha, Aa^Vca, Ai, Ms, Aa, Rd, Hhd, Qlf, Hhd, Hhd, Rd, Hhd, Ha, Rd, Hhd, Rd, Aa, Md, Qlf, Qlf, Md, Md, Ms, Ms
Aa, Aa^Fpa, Aa^Fpa, Ha, Ai, Ha, Ms^Xm, Ms^Xm, Ms^Xm, Hhd, Aa, Aa^Fpa, Aa^Fpa, Ha^Fpa, Aa, Ha, Aa, Ms, Md, Md, Qlf, Qlf, Md, Ms, Ha, Ms
Aa, Aa, Aa, Ai, Ai, Ms^Xm, Ms^Xm, Ms^Xm, Ms^Xm, Ms^Xm, Aa, Aa, Aa, Aa, Aa, Aa, Aa, Ms, Rd, Qlf, Qlf, Qlf, Hhd, Ha, Ha, Ha
