Hh, Hh, Hh, Hh, Hh, Hh, Hh, Mm, Mm, Mm, Mm, Gs, Gs, Mm, Mm, Mm, Mm, Gs, Gs, Gs, Hh, Gs, Mm, Mm, Mm, Mm, Gs, Mm, Mm, Mm, Hh, Gs, Gs, Mm, Mm, Gs, Mm, Gs, Mm, Mm, Mm, Mm^Xm, Mm^Xm, Mm^Xm, Mm^Xm, Mm
Hh, Hh, Hh, Hh, Hh, Hh, Mm, Mm, Mm^Xm, Mm, Gs, Gs, Gs, Gs, Gs, Gs, Mm, Hh, Mm, Hh, Mm, Hh, Mm, Mm, Mm, Mm, Mm, Mm, Mm, Mm, Mm, Mm, Mm, Hh, Mm, Mm, Hh, Mm, Mm, Mm, Mm, Mm, Hh, Mm^Xm, Mm^Xm, Mm
Hh, Hh, Hh, Hh, Hh, Hh, Mm^Xm, Mm^Xm, Mm^Xm, Mm, Gs, Gs, Gs, Gs, Hh, Mm, Mm, Mm^Fp, Mm, Mm, Gs, Gs, Gs, Mm, Mm, Mm, Gs, Mm^Fp, Mm, Mm, Gs, Mm, Mm, Mm, Mm, Mm, Hh, Mm, Mm, Mm^Fp, Mm^Xm, Mm^Xm, Mm^Xm, Mm^Xm, Mm, Mm
Hh, Hh, Hh^Fp, Hh, Mm, Mm, Mm^Xm, Mm^Xm, Mm, Mm, Mm, Mm, Hh, Mm, Mm, Mm, Mm, Mm, Mm, Mm, Gs, Gs, Mm, Mm, Mm, Mm, Gs, Gs, Hh, Gs, Mm, Mm, Mm, Mm, Mm, Mm^Fp, Mm, Mm, Mm, Mm, Mm^Xm, Mm^Xm, Mm^Xm, Hh, Mm, Mm
Hh, Hh, Hh^Fp, Hh, Hh, Mm, Mm, Mm, Mm, Mm, Gs^Fp, Gs, Hh, Mm, Mm, Mm, Mm^Vc, Mm, Hh, Gs, Mm, Mm, Gs, Gs, Gs, Gs, Mm, Gs, Gs, Hh, Hh, Gs, Gs, Mm, Gs, Mm, Gs, Mm, Mm, Hh, Mm, Mm^Xm, Gs, Mm, Mm, Mm
Hh, Hh^Fp, Hh^Fp, Hh, Hh, Mm, Mm, Mm, Gs, Gs, Gs, Gs^Fp, Hh, Mm, Mm, Mm, Hh, Hh, Hh, Hh, Mm^Xm, Gs, Mm, Gs, Hh, Mm, Mm, Mm, Mm, Mm, Mm^Vc, Hh, Hh, Hh, Hh, Mm, Gs, Mm, Mm, Mm, Mm, Mm, Gs, Mm, Mm, Mm
Hh, Hh, Hh, Hh, Gs, Mm, Mm, Mm, Gs, Gs^Vc, Gs, Gs, Gs, Hh, Mm, Mm, Gs, Gs, Mm^Xm, Mm^Xm, Mm^Xm, Mm, Mm, Gs, Hh, Mm, Mm^Xm, Mm^Xm, Hh, Mm, Mm, Mm, Mm, Hh, Hh, Hh^Fp, Hh^Fp, Mm, Gs, Mm, Gs^Vc, Mm, Mm, Gs, Mm, Mm
Mm^Xm, Mm^Xm, Gs, Gs, Mm, Mm, Gs, Gs, Gs, Gs, Gs, Gs, Gs, Gs, Hh, Mm, Mm, Gs, Gs, Mm^Xm, Mm^Xm, Gs, Mm, Gs, Gs, Mm, Mm, Mm^Xm, Mm^Xm, Hh, Mm, Mm, Mm, Hh, Hh, Hh^Fp, Hh, Hh, Mm^Xm, Gs, Gs, Mm, Gs, Gs, Mm, Mm
Mm^Xm, Mm^Xm, Mm^Xm, Gs, Gs, Gs, Cte, Cte, Cte, Gs, Gs, Mm, Hh, Hh, Hh, Hh, Hh, Gs, Gs, Gs, Mm, Mm, Mm, Mm, Mm, Mm, Gs, Mm, Hh, Mm, Hh, Mm, Mm, Mm, Mm, Hh, Hh, Mm^Xm, Mm^Xm, Mm^Xm, Gs, Mm, Gs, Gs, Mm, Mm
Mm^Xm, Mm^Xm, Gs, Gs, Mm, Mm, Cte, 2 Kte, Cte, Gs, Mm, Mm, Hh, Hh, Hh^Fp, Hh^Fp, Gs, Gs, Mm, Mm, Mm, Mm, Gs, Gs, Gs, Mm, Mm^Xm, Hh, Hh, Mm, Mm, Mm, Md, Mv, Md, Mm, Hh, Hh, Mm^Xm, Mm^Xm, Gs, Mm, Mm, Gs, Gs, Mm
Mm, Mm^Xm, Gs, Mm, Mm, Mm, Hh, Cte, Hh, Gs, Mm, Gs, Hh, Gs, Hh, Hh, Gs, Mm, Mm, Mm, Gs, Gs, Mm, Mm, Mm, Mm^Xm, Mm^Xm, Mm^Xm, Mm, Ww, Ww, Mm, Mm, Md, Mm, Mm, Gs, Hh, Hh, Hh, Mm, Mm, Mm^Fp, Gs, Gs, Mm
Mm, Mm, Mm, Mm, Mm, Mm, Mm, Hh, Hh, Hh, Mm, Hh, Gs, Hh, Hh, Hh, Mm, Mm, Gs, Gs, Mm, Mm, Mm^Vu, Gs, Mm, Mm, Mm, Mm, Mm, Ww, Ww, Ww, Mm, Hh, Hh, Mm, Mm, Gs, Gs, Mm, Mm, Mm, Mm, Gs, Mm^Fp, Mm
Mm, Mm, Mm, Mm, Gs, Mm, Gs, Mm, Gs, Hh, Hh, Hh, Hh^Vc, Hh, Hh, Hh, Hh, Hh, Gs, Mm, Mm, Mm, Mm^Xm, Mm, Mm, Mm, Mm, Mm, Mm, Ww, Ww, Ww, Hh, Gs, Mm, Hh, Mm, Mm, Gs, Mm, Mm^Xm, Mm, Mm, Mm, Mm, Mm
Gs, Mm, Gs, Gs, Hh^Vc, Gs, Hh, Gs, Mm, Hh, Gs, Hh, Hh, Hh, Hh^Fp, Hh, Hh, Gs, Gs, Mm^Xm, Mm^Xm, Mm^Xm, Mm, Mm, Mm, Mm, Mm^Vu, Mm, Ww, Ww, Mm, Hh, Hh, Hh, Hh, Mm, Hh^Fp, Mm^Fp, Gs^Fp, Mm^Xm, Mm^Xm, Mm^Xm, Mm, Mm, Mm, Mm
Gs, Gs, Hh, Hh, Hh, Hh, Mm, Mm, Mm, Mm, Mm, Hh, Gs, Hh, Gs, Gs^Fp, Gs, Gs, Mm^Xm, Mm, Ce, Mm, Mv, Mm, Ce, Mm, Ww, Ww, Mm, Mm, Mm, Mm, Hh, Hh, Hh, Hh, Gs, Gs^Fp, Gs, Mm^Xm, Mm, Mm, Mm, Mm, Gs, Mm
Gs, Hh, Hh, Gs, Hh, Hh, Hh, Mm, Mm, Mm, Mm, Hh, Mm, Gs, Mm, Gs^Fp, Hh, Gs, Hh, Mm^Vu, Ce, Md, Md, Md, Ce, Mm, Hh, Ww, Gs, Gs, Gs, Mm, Gs, Gs, Hh, Gs, Gs^Vc, Mm, Mm, Gs, Gs, Mm, Mm, Mm, Gs^Fp, Mm
Hh, Hh, Mm^Xm, Mm^Xm, Mm^Xm, Hh, Hh, Hh, Mm, Mm, Mm, Mm, Mm, Mm, Gs, Hh, Gs, Gs, Mm, Hh, Mm, Ce, 1 Ke, Ce, Mm, Mm, Mm, Ww, Ww, Gs, Gs, Gs, Gs, Hh, Gs, Mm, Hh, Gs, Gs, Mm, Gs, Gs, Gs, Gs^Fp, Gs, Mm
Mm^Xm, Mm, Gs, Hh, Mm^Xm, Mm^Xm, Gs, Hh, Hh, Mm, Mm, Mm^Fp, Mm^Xm, Mm^Xm, Hh, Hh, Gs, Hh, Mm, Mm, Mm, Mm, Mm, Mm, Mm, Mm, Mm, Mm, Ww, Hh, Ww, Gs, Ww, Gs, Gs, Mm, Mm, Gs, Gs, Mm, Mm^Xm, Mm, Gs, Gs, Mm, Mm
Mm^Xm, Mm, Mm, Hh^Fp, Hh^Fp, Mm^Xm, Hh, Hh, Hh, Mm, Gs, Mm^Xm, Mm, Mm, Hh, Hh, Gs, Gs, Mm^Vu, Mm, Mm, Mm, Mm, Mm, Mm, Mm, Mm^Xm, Mm^Vu, Gs, Ww, Mm, Ww, Gs, Ww, Ww, Hh, Mm, Mm, Mm, Mm^Xm, Hh, Mm, Gs, Gs^Vc, Gs, Gs
Mm^Xm, Mm^Xm, Mm, Hh, Mm, Mm, Gs, Gs, Mm, Mm, Mm, Mm, Mm, Mm, Hh, Hh, Hh, Gs, Gs, Mm, Mm, Mm, Mm, Mm, Mm, Mm^Xm, Mm^Xm, Gs, Gs, Gs, Mm, Mm, Mm, Mm, Hh, Ww, Ww, Hh, Ww, Gs, Ww, Hh, Ww, Gs, Ww, Gs
Mm^Xm, Mm^Xm, Mm, Mm, Mm, Mm, Ww, Gs, Mm, Mm, Gs, Mm, Mm^Vc, Mm, Mm, Mm^Fp, Gs, Hh, Hh, Gs, Gs, Mm, Mm^Vu, Mm, Mm^Xm, Mm^Xm, Gs, Gs, Mm, Mm, Mm, Mm, Gs, Mm, Hh, Hh, Mm, Ww, Mm, Ww, Mm, Ww, Gs, Ww, Hh, Ww
Mm^Xm, Mm^Xm, Md, Mv, Md, Mm, Ww, Ww, Ww, Mm, Mm, Mm, Gs, Mm, Mm, Mm, Mm, Hh, Hh, Hh, Hh, Gs, Gs, Mm, Mm^Xm, Mm^Xm, Mm, Mm, Mm, Mm, Mm, Mm, Mm, Mm, Hh^Fp, Gs, Gs, Mm, Hh, Mm, Hh, Mm, Mm, Hh, Hh, Gs
Mm^Xm, Mm, Mm, Md, Mm, Ww, Ww, Ww, Mm^Xm, Mm^Xm, Mm, Mm, Mm, Mm, Mm, Mm, Mm^Fp, Hh, Hh, Hh, Hh, Hh, Hh, Gs, Gs, Gs, Mm, Mm, Gs, Mm, Mm, Mm, Mm, Mm, Hh^Fp, Hh, Hh, Hh, Hh, Hh, Cte, Hh, Mm, Mm, Hh, Hh
Mm^Xm, Mm^Xm, Hh, Gs, Mm, Ww, Gs, Gs, Gs, Mm, Mm, Mm, Mm, Mm, Mm, Mm, Mm, Hh, Gs, Gs, Gs, Hh, Hh^Fp, Hh, Gs, Gs, Mm, Mm, Mm, Mm, Hh, Hh, Hh, Hh^Fp, Hh^Fp, Hh, Hh^Vc, Hh, Hh, Cte, 3 Kte, Cte, Hh, Mm, Hh, Hh
Mm^Xm, Mm^Xm, Hh, Hh, Hh, Gs, Gs, Hh, Gs, Mm, Mm, Gs, Gs, Mm, Gs, Mm, Gs, Hh, Gs, Mm, Gs, Mm, Gs, Hh, Hh, Gs, Mm, Mm, Mm, Mm, Hh, Hh, Mm, Hh, Mm, Hh, Hh, Hh, Hh, Cte, Cte, Cte, Hh, Hh, Hh, Gs
Mm^Xm, Hh, Hh, Hh, Hh, Gs, Mm, Hh^Fp, Hh^Fp, Gs, Gs, Gs, Mm, Gs, Mm, Gs, Gs, Hh, Hh, Mm, Mm, Mm, Mm, Gs, Gs, Hh, Gs^Fp, Mm, Mm, Mm, Gs, Hh, Mm, Mm^Xm, Mm^Xm, Mm, Hh, Hh, Hh, Hh, Hh, Hh, Hh, Mm, Hh, Gs
Mm^Xm, Mm^Xm, Hh, Hh, Hh, Mm, Mm, Hh^Fp, Hh, Hh, Gs, Gs, Mm, Mm, Mm, Mm, Mm, Gs, Hh, Gs, Mm, Mm, Mm, Mm, Gs, Hh, Gs^Fp, Mm^Fp, Ww, Hh, Hh, Hh, Hh, Mm, Mm^Xm, Mm, Gs, Mm, Mm, Mm, Mm, Mm, Hh, Hh^Vc, Hh, Gs
Mm^Xm, Mm^Xm, Hh, 5 Hh, Hh, Mm, Mm^Vc, Hh, Hh, Hh, Hh, Mm, Mm, Mm^Vc, Mm, Mm, Mm, Mm, Hh, Hh, Mm, Mm, Mm, Mm, Gs, Hh, Hh, Hh^Fp, Ww, Ww, Hh, Hh, Gs, Hh, Hh, Mm, Hh, Hh, Hh, Hh, Hh, Hh, Gs, Hh, Gs, Gs
Mm^Xm, Mm^Xm, Mm, Hh, Mm, Mm, Gs, Hh, Hh, Hh, Hh, Hh, Hh, Mm, Mm, Mm, Mm, Gs, Hh, Gs, Gs, Mm, Mm^Vc, Mm, Hh, Hh, Ww, Ww, Ww, Ww, Hh, Hh, Hh, Hh^Vc, Gs, Mm, Mm, Gs, Gs, Hh, Gs, Hh, Hh, Gs, Mm, Mm
Mm^Xm, Gs, Mm, Mm, Mm, Mm, Mm, Mm, Hh, Mm^Xm, Mm^Xm, Mm^Xm, Mm^Xm, Hh, Mm^Xm, Mm, Mm, Hh, Gs, Gs, Mm, Gs, Mm, Mm, Mm, Mm, Hh, Mm, Mm, Mm, Mm, Mm, Mm, Mm, Gs, Gs, Gs, Gs, Hh, Gs, Hh^Fp, Hh, Mm, Mm^Xm, Gs, Gs
Hh, Gs, Mm^Fp, Mm, Mm, Mm, Mm, Gs, Gs, Mm^Xm, Mm^Xm, Mm^Xm, Mm^Xm, Mm^Xm, Mm^Xm, Mm^Xm, Mm^Xm, Mm^Xm, Mm, Mm, Gs, Mm, Hh, Hh, Hh, Hh, Hh, Hh, Gs, Mm, Gs, Hh, Hh, Hh, Hh, Hh, Hh, Hh, Gs, Hh^Fp, Mm^Fp, Mm^Fp, Gs, Mm^Xm, Mm^Xm, Mm
Hh, Hh, Mm, Mm^Fp, Mm^Fp, Mm, Mm, Mm, Mm, Mm^Xm, Mm, Mm^Xm, Hh, Mm^Xm, Mm^Xm, Mm^Xm, Mm^Xm, Mm^Xm, Mm^Xm, Gs, Gs, Gs, Hh, 4 Hh, Hh, Hh^Vc, Hh, Hh, Hh, Gs, Gs, Gs, Gs, Gs, Gs, Gs, Mm, Gs, Mm, Mm, Mm, Gs^Fp, Mm^Xm, Mm^Xm, Mm^Xm, Mm
Gs, Mm, Mm, Mm, Mm, Hh, Mm, Mm, Mm, Mm, Mm, Mm, Mm, Gs, Hh, Gs, Gs, Mm^Xm, Hh^Fp, Mm^Xm, Mm, Hh, Hh, Hh, Mm, Mm, Mm, Mm, Mm, Hh, Mm^Xm, Mm^Xm, Mm^Xm, Mm, Mm, Mm, Mm, Mm, Mm, Mm, Mm, Mm, Mm^Xm, Mm^Xm, Hh, Hh
Hh, Hh, Hh, Mm, Mm, Mm, Hh, Mm, Mm, Mm, Mm, Mm, Mm, Mm, Hh, Hh, Hh, Hh^Fp, Hh, Mm, Mm, Hh, Mm, Mm, Mm, Mm, Mm, Mm, Mm^Xm, Mm^Xm, Mm^Xm, Mm^Xm, Mm, Mm, Mm, Mm, Hh, Mm, Mm, Mm, Mm, Mm, Hh, Hh, Hh, Hh
Hh, Hh, Hh, Hh, Hh, Hh, Hh, Hh, Hh, Hh, Hh, Mm, Hh, Hh, Hh, Hh, Hh, Hh, Hh, Hh, Mm, Mm, Gs, Gs, Gs, Mm, Mm, Mm, Mm, Mm^Xm, Mm, Mm, Mm, Mm, Gs, Mm, Mm, Mm, Mm, Mm, Hh, Hh, Hh, Hh, Hh, Hh
