Gg, Gg^Fp, Gg, Gg, Hh, Gg, Hh, Gg, Mm, Mm^Xm, Gg, Mm, Mm, Mm, Hh, Hh^Fp, Hh, Gg, Mm, Gg, Hh, Gg, Hh, Hh, Gg, Mm, Mm, Mm, Gg, Gg, Mm, Qxu, Qxu, Mm^Xm, Mm^Xm, Mm^Xm, Ww, Ww
Hh, Hh, Hh, Hh, Hh, Hh, Hh, Gg, Mm, Mm, Mm, Mm, Mm, Mm, Mm, Hh, Hh, Hh, Mm, Hh, Gg, Hh, Hh, Hh, Mm, Mm, Gg, Gg, Mm, Mm, Mm, Qxu, Mm, Mm, Mm, Mm, Ww, Ww
Mm^Xm, Hh, Mm, Mm, Mm, Hh, Gg, Gg, Mm, Mm, Mm, Mm, Gg, Mm, Gg, Mm, Gg, Hh, Hh, Hh, Hh^Vd, Hh, Hh, Hh, Hh, Hh, Gg, Mm, Mm, Mm, Mm^Xm, Mm, Mm, Mm^Vd, Mm, Mm, Mm, Ww
Mm^Xm, Mm^Xm, Mm^Xm, Mm^Xm, Gg, Mm, Gg, Gg, Gg, Mm, Gg, Gg, Hh^Vd, Gg, Hh, Gg, Mm, Hh, Gg, Hh, Hh, Hh, Hh^Fp, Hh, Hh, Gg, Gg, Mm^Xm, Mm^Xm, Mm^Xm, Mm, Mm, Mm, Mm, Mm, Mm, Ww, Ww
Mm^Xm, Mm^Xm, Mm, Gg, Gg, Gg, Gg, Gg^Fp, Gg, Gg, Hh, Hh, Hh, Hh, Mm, Mm, Mm, Mm, Mm, Hh, Gg, Hh, Gg, Gg^Fp, Gg, Gg, Hh, Mm, Ch, Mm, Mv, Mm, Ch, Mm, Ww, Ww, Mm, Mm
Mm, Mm, Gg^Fp, Gg^Fp, Gg^Fp, Gg, Gg^Fp, Gg^Fp, Gg, Hh, Hh, Gg, Hh, Hh, Hh, Mm, Mm, Mm, Mm, Hh, Mm, Gg, Mm, Gg^Fp, Hh, Gg, Hh, Hh^Vd, Ch, Md, Md, Md, Ch, Mm, Hh, Ww, Gg, Gg
Gg, Gg, Gg^Fp, Gg^Fp, Gg^Fp, Gg^Fp, Gg^Fp, Gg, Hh, Hh, Mm^Xm, Mm^Xm, Mm^Xm, Hh, Hh, Hh, Mm, Mm, Mm, Mm, Mm, Mm, Gg, Hh, Gg, Gg, Hh, Hh, Mm, Ch, 1 Kh, Ch, Mm, Mm, Mm, Ww, Ww, Gg
Gg, Gg, Gg, Gg^Fp, Gg, Gg^Fp, Gg^Fp, Gg, Qxu, Qxu, Qxu, Qxu, Mm^Xm, Mm^Xm, Gg, Hh, Hh, Mm, Mm, Mm^Fp, Mm^Xm, Mm^Xm, Hh, Hh, Gg, Hh, Mm, Mm, Mm, Mm, Mm, Mm, Mm, Mm, Mm, Mm, Ww, Hh
Gg, Gg, Gg, Gg, Hh, Gg, Gg, Hh, Hh, Qxu, Hh, Hh^Fp, Hh^Fp, Mm^Xm, Hh, Hh, Hh, Hh, Hh, Mm^Xm, Mm, Mm, Hh, Hh, Gg, Gg, Mm, Mm, Mm, Mm, Mm, Mm, Mm, Mm, Hh, Mm^Vd, Gg, Ww
Hh, Hh, Gg^Fp, Hh, Gg^Vd, Hh, Hh, Gg, Hh, Hh, Mm, Hh^Fp, Hh, Mm, Gg, Gg, Hh, Hh, Hh, Mm, Hh, Hh, Hh, Hh, Hh, Gg, Gg, Mm, Mm, Mm, Mm, Mm, Mm, Hh, Hh, Gg, Gg, Gg
Hh, Gg, Hh, Gg^Fp, Hh^Fp, Hh, Gg, Gg, Hh, Hh, Mm, Mm, Mm, Hh, Ww, Ww, Ww, Hh, Gg, Hh, Mm^Vd, Mm, Mm, Mm^Fp, Gg, Hh, Hh, Gg, Gg, Mm^Vd, Mm, Mm, Hh, Hh, Gg, Gg, Mm, Mm
Mm^Xm, Hh, Hh, Hh, Hh^Fp, Hh, Gg, Hh, Mm^Xm, Mm, Md, Mv, Md, Hh, Ww, Ww, Ww, Hh, Hh, Mm, Gg, Mm, Mm, Mm, Mm, Hh, Hh, Hh, Hh, Gg, Gg, Mm, Hh, Gg, Gg, Gg, Mm, Mm
Mm^Xm, Mm^Xm, Gg, Hh, Gg, Gg^Fp, Gg^Fp, Hh, Mm^Xm, Mm, Mm, Md, Hh, Hh, Ww, Ww, Ww, Hh, Mm, Mm^Xm, Mm, Mm, Mm, Mm, Mm^Fp, Hh, Hh, Hh, Hh, Hh, Hh^Fp, Gg, Gg, Gg, Mm, Gg, Gg, Mm
Mm^Xm, Mm^Xm, Gg, Gg, Hh, Gg^Fp, Gg^Fp, Gg, Mm^Xm, Mm^Xm, Hh, Mm, Hh, Ww, Ww, Ww, Gg, Hh, Mm, Mm^Xm, Mm, Mm, Mm, Mm, Mm, Hh, Gg, Gg, Gg, Hh^Fp, Hh^Fp, Hh, Gg, Gg, Mm, Mm, Md, Md
Mm^Xm, Mm^Xm, Hh^Fp, Hh^Fp, Gg^Fp, Gg^Fp, Gg, Gg, Hh, Hh, Hh, Hh, Ww, Ww, Gg, Hh, Gg, Mm, Mm, Qxu, Qxu, Mm, Qxu, Mm, Hh, Hh, Gg, Mm, Gg, Mm, Rd, Hh, Hh, Gg, Mm, Mm, Md, Qlf
Mm^Xm, Gg, Hh, Hh, Gg^Vd, Gg, Gg, Gg, Ww, Ww, Ww, Ww, Hh, Gg, Mm, Hh^Fp, Hh^Fp, Gg, Gg, Gg, Hh, Qxu, Hh, Hh, Hh, Hh, Hh, Mm, Mm, Md, Qlf, Rd, Gg, Hh, Gg^Fp, Mm, Mm, Md
Gg, Gg^Fp, Gg, Gg, Ww, Ww, Ww, Ww, Mm^Xm, Ww, Hh, Hh, Hh, Mm, Mm, Hh^Fp, Hh, Hh, Gg, Gg, Mm, Hh, Mm, Hh, Mm, Gg, Hh, Gg, Mm, Md, Qlf, Md, Rd, Hh, Gg^Fp, Mm^Fp, Hh^Fp, Hhd
Gg, Gg^Fp, Gg^Fp, Gg, Ww, Gg, Gg, Mm, Mm, Mm, Hh, Hh, Hh, Mm, Mm^Vd, Hh, Hh, Hh, Hh, Mm, Mm, Mm^Vd, Mm, Mm, Mm, Hh, Hh, Hh^Fp, Mm^Fp, Md, Md, Qlf, Qlf, Hhd, Hh, Hh^Fp, Hh, Hhd
Gg, Gg, Ww, Ww, Gg, Gg, Gg, Gg, Mm^Xm, Mm^Xm, Hh, Hh, Mm, Mm, Gg, Hh, Hh, Hh, Hh, Hh, Hh, Mm, Mm, Mm, Hh, Gg, Hh, Gg^Fp, Gg, Mm, Mm^Vd, Md, Md, Hhd, Hhd, Hhd, Hhd, Hh
Ww, Ww, Gg, Gg^Fp, Gg^Fp, Mm, Mm, Qxu, Mm^Xm, Gg, Mm, Mm, Mm, Mm, Gg, Hh, Hh, Hh, Mm, Mm^Xm, Mm, Hh, Hh, Hh, Mm, Hh, Gg, Gg, Md, Gg, Mm, Mm, Mm, Hh, Hhd, Qlf, Hhd, Mm
Gg, Gg, Mm, Mm, Hh, Mm, Mm, Qxu, Hh, Gg, Mm^Fp, Mm, Mm, Mm, Hh, Gg, Gg, Mm, Mm^Xm, Mm^Xm, Mm, Hh, Hh, Mm, Mm^Xm, Mm^Xm, Mm, Md, Qlf, Md, Hh, Hh, Hh, Hh, Hh, Md, Mm, Hhd
Hh, Gg, Hh, Mm, Hh, Hh, Mm, Qxu, Hh, Hh, Mm, Mm^Fp, Mm^Fp, Mm, Hh, Hh, Mm, Mm^Xm, Mm, Mm, Hh, Hh, Mm, Mm^Xm, Mm^Xm, Mm^Xm, Mm^Xm, Rd, Rd, Rd, Hh, Hh^Fp, Hh^Fp, Mm, Mm, Hh, Hhd, Hhd
Hh, Hh, Gg^Vd, Mm, Gg, Mm, Mm, Qxu, Hh, Mm, Mm, Mm, Mm, Hh, Hh, Mm, Mm, Mm, Mm, Mm, Mm, Hh, Hh, Mm, Gg, Mm, Mm^Fp, Mm^Xm, Mm, Hh, Hh, Hh^Fp, Hh, Mm, Hhd, Hhd, Qlf, Hhd
Mm, Gg, Gg, Gg, Gg, Gg, Qxu, Qxu, Hh, Hh, Hh, Mm, Hh, Hh, Hh, Mm, Mm, Mm^Fp, Mm, Mm, Mm, Mm, Hh, Hh, Hh, Hh^Fp, Hh, Mm, Hh, Hh^Vd, Md, Hh, Hh, Hhd, Qlf, Qlf, Hhd, Wwt
Gg, Mm, Mm, Mm, Gg, Gg, Hh, Gg, Hh^Fp, Hh^Fp, Hh, Hh, Hh, Hh, Hh, Hh, Hh, Hh, Hh, Mm, Hh, Hh, Hh, Hh, Hh, Hh, Hh, Hh, Mm, Md, Qlf, Md, Gg, Md, Md, Qlf, Wwt, Ww
Gg, Mm, Mm, Mm, Mm, Hh, Hh, Hh, Gg, Gg, Mm, Mm, Gg, Gg^Fp, Gg^Fp, Gg, Gg, Gg, Hh, Gg, Hh, Hh, Hh^Fp, Hh^Fp, Hh^Fp, Hh, Hh, Hh, Hh, Md, Qlf, Md, Hh, Gg, Ww, Wwt, Gg^Fp, Mm
Mm, Mm, Mm, Mm, Gg^Fp, Gg^Fp, Gg, Gg^Vd, Gg, Gg, Mm, Mm, Mm, Gg^Fp, Hh, Hh, Hh, Hh, Gg^Vd, Hh, Gg, Gg^Fp, Gg, Gg, Gg^Fp, Hh^Fp, Gg, Hh, Gg, Hhd, Qlf, Hhd, Hh, Gg^Fp, Ww, Gg^Fp, Qlf, Hhd
Gg, Mm, Gg, Gg, Hh, Gg^Fp, Hh, Gg, Hh, Gg, Mm, Mm, Gg^Fp, Gg^Fp, Gg, Hh, Gg, Gg, Mm, Mm, Mm, Hh, Mm, Mm, Mm, Mm, Mm, Gg, Gg, Hhd, Qlf, Hhd, Md, Gg^Fp, Wwt, Md, Qlf, Qlf
Gg, Gg, Gg, Hh, Mv, Hh, Hh, Hh, Mm, Mm, Hh, Hh, Hh^Fp, Gg^Fp, Gg, Mm, Mm, Mm, Mm, Mm, Mm, Hh, Mm, Mm, Mm, Mm, Mm, Gg, Gg, Hhd, Hhd, Qlf, Md, Mm, Wwt, Qlf, Rd, Rd
Gg, Gg, Hh, Md, Md, Md, Mm, Hh, Hh, Mm, Hh, Hh^Fp, Hh, Hh, Hh, Gg, Gg, Mm, Mm, Mm, Gg, Hh, Mm^Fp, Mm, Mm, Mm, Mm, Mm, Gg, Hh, Hhd, Qlf, Qlf, Hhd, Ww, Md, Mm, Gg^Vc
Gg, Mm, Hh, Mm, Mm, Hh, Mm, Hh, Gg, Hh, Hh, Hh, Hh, Hh, Gg, Gg^Vd, Hh, Qxu, Gg, Hh, Hh, Gg, Gg^Fp, Gg, Gg, Gg^Vd, Hh, Gg, Hh^Fp, Hh^Fp, Hh, Hhd, Hhd, Hhd, Ww, Mm, Md, Rd
Gg, Mm, Hh, Hh, Hh, Mm, Mm, Mm, Mm^Vd, Gg, Gg, Gg, Gg, Mm, Mm^Xm, Mm, Qxu, Qxu, Gg^Fp, Gg, Gg, Gg^Fp, Hh^Fp, Hh, Hh, Hh, Hhd, Gg, Hhd, Hh^Fp, Hh, Hh, Ww, Ww, Mm, Mm, Rd, Qlf
Hh, Hh, Gg^Vd, Gg, Gg, Gg, Hh, Gg, Gg, Gg, Gg^Fp, Gg^Fp, Gg, Mm^Xm, Mm^Xm, Mm^Xm, Hh, Hh, Gg^Fp, Gg, Hh, Gg, Hh, Hh^Fp, Rd, Hhd, Qlf, Hhd, Qlf, Hhd, Ww, Ww, Mm, Mm, Mm^Xm, Mm^Xm, Hh, Hhd
Hh, Hh, Gg, Gg, Ce, Gg, Hh, Gg, Gg, Hh, Hh^Fp, Hh^Fp, Hh, Gg, Gg, Gg, Hh, Gg^Fp, Gg^Fp, Gg^Fp, Hh^Fp, Hh, Rd, Hhd, Qlf, Qlf, Qlf, Qlf, Wwt, Wwt, Md, Md, Md^Xm, Mm^Xm, Rd, Hhd, Rd, Gg^Fp
Gg, Gg, Gg, Ce, 2 Ke, Ce, Gg, Hh, Hh, Hh, Gg^Vd, Hh^Fp, Gg^Fp, Gg^Fp, Gg, Gg, Mm, Mm^Xm, Mm^Xm, Gg^Fp, Gg, Hhd, Qlf, Qlf, Hhd, Hhd, Hhd, Hhd, Ww, Mm, Md, Qlf, Qlf, Rd, Qlf, Qlf, Qlf, Md
Hh, Hh, Gg, Ce, Ce, Ce, Gg, Hh, Hh, Hh, Hh, Hh^Fp, Hh^Fp, Gg^Fp, Mm, Mm, Md, Md^Xm, Md^Xm, Gg, Mm, Rd, Hhd, Hhd, Gg^Fp, Hh^Fp, Hh, Gg^Vd, Ww, Mm, Gg, Rd, Hhd, Qlf, Hhd, Hhd, Rd, Hhd
Hh, Hh, Hh, Gg, Qxu, Qxu, Qxu, Hh, Gg, Gg, Hh, Hh, Hh^Fp, Gg, Rd, Md, Qlf, Qlf, Qlf, Md, Md, Hh, Hh, Hh, Gg, Gg^Fp, Gg^Fp, Hh, Ww, Hh, Mm^Xm, Mm^Xm, Mm^Xm, Hhd, Gg, Gg^Fp, Gg^Fp, Hh^Fp
Hh, Hh, Gg, Qxu, Qxu, Qxu, Qxu, Hh, Gg, Gg, Hh, Hh, Gg, Gg^Fp, Rd, Qlf, Qlf, Qlf, Qlf, Qlf, Rd, Hh, Gg, Hh, Gg, Gg, Gg, Ww, Ww, Mm^Xm, Mm^Xm, Mm^Xm, Mm^Xm, Mm^Xm, Gg, Gg, Gg, Gg
