Aa, Ms, Ms, Ms, Aa, Aa, Ms, Qxu, Qxu, Ms^Xm, Ms^Xm, Ms^Xm, Ai, Ai, Ai, Ms, Ms, Md, Ms, Ms, Aa, Ha, Ha, Ha, Ms, Ms
Ms, Ms, Aa, Aa, Ms, Ms, Ms, Qxu, Ms, Ms, Ms, Ms, Ai, Ai, Ai, Ai, Ms, Ha, Ha, Ms, Ms, Aa, Aa, Ms, Ms, Ms
Ha, Ha, Aa, Ms, Ms, Ms, Ms^Xm, Ms, Ms^Vd, Ms, Ms, Ms, Ms, Ai, Ai, Ai, Ha, Aa, Ms, Ha, Ms, Aa^Vca, Aa, Ms, Ms^Xm, Ms
Ha, Aa, Aa, Ms^Xm, Ms^Xm, Ms^Xm, Ms, Ms, Ms, Ms, Ms, Ms, Ai, Ai, Ms, Ha, Ha, Ha, Ha, Ms, Ha^Fpa, Ms^Fpa, Aa^Fpa, Ms^Xm, Ms^Xm, Ms^Xm
Aa, Aa, Ha, Ms, Cha, Ms, Mv, Ms, Cha, Ms, Ai, Ai, Ms, Ms, Ms, Ms, Ha, Ha, Ha, Ha, Aa, Aa^Fpa, Aa, Ms^Xm, Ms, Ms
Ha, Aa, Ha, Ha^Vd, Cha, Md, Md, Md, Cha, Ms, Ha, Ai, Aa, Aa, Aa^Fpa, Ms, Aa^Fpa, Aa, Ha, Aa, Aa, Ms, Ms, Aa, Aa, Ms
Aa, Aa, Ha, Ha, Ms, Cha, 1 Kha, Cha, Ms, Ms, Ms, Ai, Ai, Aa, Aa, Aa^Fpa, Aa, Ha, Aa, Ms, Ha, Aa, Aa, Ms, Aa, Aa
Aa, Ha, Ms, Ms, Ms, Ms, Ms, Ms, Ms, Ms, Ms, Ms, Ai, Ha, Ai, Aa, Ai, Aa, Aa, Ms, Ms, Aa, Aa, Ms, Ms^Xm, Ms
Aa, Aa, Ms, Ms, Ms, Ms, Ms, Ms, Ms, Ms, Ha, Ms^Vd, Aa, Ai, Ms, Ai, Aa, Ai, Ai, Ha, Ms, Ms, Ms, Ms^Xm, Ha, Ms
Ha, Aa, Aa, Ms, Ms, Ms, Ms, Ms, Ms, Ha, Ha, Aa, Aa, Aa, Ms, Ms, Ms, Ms, Ha, Ai, Ai, Ha^Vca, Ai, Aa, Ai, Ha
Aa, Ha, Ha, Aa, Aa, Ms^Vd, Ms, Ms, Ha, Ha, Aa, Aa, Ms, Ms, Ms, Ms, Aa, Ms, Ha, Ha, Ms, Ai, Ms, Ai, Ms, Ai
Ms, Ha, Ha, Ha, Ha, Aa, Aa, Ms, Ha, Aa, Aa, Aa, Ms, Ms, Ms, Ms, Ms, Ms, Ha^Fpa, Aa, Aa, Ms, Ha, Ms, Ha, Ms
Ms^Fpa, Ha, Ha, Ha, Ha, Ha, Ha^Fpa, Aa, Aa, Aa, Ms, Aa, Aa, Ms, Ms, Ms, Ms, Ms, Ha^Fpa, Ha, Ha, Ha, Ha, Ha, Ha, Ha
Ms, Ha, Aa, Aa, Aa, Ha^Fpa, Ha^Fpa, Ha, Aa, Aa, Ms, Ms, Ms, Qxu, Qxu, Ha, Ha, Ha^Fpa, Ha^Fpa, Ha, Ha^Vca, Ha, Ha, Ha, Ha, Ha
Ha, Ha, Aa, Ms, Aa, Ms, Aa, Ha, Ha, Aa, Ms, Ms, Ms, Qxu, Qxu, Ha, Ms, Ha, Ms, Ha, Ha, Ha, Ha, Ha, Ms, Ha
Ha, Ha, Ha, Ms, Ms, Qxu, Qxu, Aa, Aa, Ha, Aa^Fpa, Ms, Ms, Ms, Qxu, Ms, Ms, Ms^Xm, Ms^Xm, Ms, Ms, Ms, Ms, Ms, Ms, Ha
Ms, Aa, Ha, Aa, Ms, Ms, Qxu, Ms, Aa, Ha, Aa^Fpa, Ms^Fpa, Ha^Fpa, Ha, Qxu, Ha, Ha, Ms, Ms^Xm, Ms, Ai, Ai, Ai, Ms, Ms, Ms
Ms, Ha, Ha, Ha^Fpa, Ms^Fpa, Ms, Ms, Qxu, Qxu, Ha, Ha, Ha^Fpa, Ha, Ha, Ha, Ha, Aa, Ha, Ai, Ai, Ai, Ai, Ai, Ms, Ms, Ha
Ha, Aa, Ha, Aa^Fpa, Aa, Ms, Ms^Vca, Ms, Ms, Ha, Ha, Ha^Fpa, Ha, Ha, Ha, Ha, Ha, Ha^Vca, Ai, Ai, Ai, Ai, Ai, Ms, Ms, Ha
Ms, Ha, Aa, Aa, Ms, Aa, Ms, Ms, Ms, Ha, Ha, Ha, Ha, Ms, Ms, Ms, Ms, Ms, Ai, Ai, Ai, Ai, Ai, Ms, Ha^Fpa, Ha
Ms^Xm, Ms^Xm, Ms, Ms, Aa, Ms, Ha, Ha, Ha, Ha, Ha, Ms, Ms, Ha, Md, Mv, Md, Ai, Ha^Fpa, Ha^Fpa, Ha, Ai, Aa, Ha^Fpa, Ms^Fpa, Ms^Fpa
Ms^Xm, Ms^Xm, Ms^Xm, Aa, Aa, Aa, Ha, Ha^Fpa, Ha^Fpa, Ms, Ms, Ha, Ha, Ha, Ha, Md, Ai, Ai, Aa^Fpa, Aa, Ms, Aa, Ms, Ms, Ms, Aa^Fpa
Aa, Ms, Ms^Fpa, Ms^Xm, Ms, Ha, Ha, Ha^Fpa, Ha, Ms, Ha, Ha, Ha, Ha, Ai, Ai, Ms, Ms, Ms^Fpa, Ms, Ms, Ms, Ms, Ms, Ms, Ms
Ha, Ha^Fpa, Ha, Ms, Ha, Ha^Vca, Ms, Ha, Ha, Ha, Md, Mv, Md, Ai, Ms, Ms, Ms, Qxu, Qxu, Ms, Ha, Ms, Ms, Ms, Ms, Ms
Ha, Ha, Ha, Ha, Ms, Ms, Qxu, Ms, Aa, Ms, Ms, Md, Ai, Ai, Ms, Ha, Ha, Ha, Ha, Qxu, Qxu, Ms^Xm, Ms^Xm, Ms, Ms, Ms
Ha^Fpa, Ha, Ha, Ha, Ha, Ms, Qxu, Ms, Ha, Aa, Ai, Ai, Aa^Fpa, Ms, Ha, Ha, Ha, Ha, Ha, Ha, Qxu, Aa, Aa^Fpa, Ms, Aa, Ms
Aa^Fpa, Ha^Fpa, Aa, Ha, Aa, Ha, Qxu, Ha, Ha, Aa^Fpa, Ai, Aa^Fpa, Ms, Ha, Ha, Ha, Md, Mv, Md, Ha, Ha, Aa, Aa^Fpa, Aa^Fpa, Ms, Aa
Ms, Ms, Ms, Aa, Aa, Ha, Qxu, Ha, Ms, Aa^Fpa, Ai, Ms, Ha, Ha, Aa, Ha, Aa, Md, Ha, Ms, Ha, Aa, Ms, Ms, Ms, Ms
Ms, Ms, Ms, Aa, Aa, Ha, Ha, Qxu, Ms, Ms, Ai, Ha, Aa, Aa, Aa, Aa, Aa, Ha, Ha, Ha, Aa, Aa, Ms, Ms, Ms^Xm, Ms^Xm
Ms, Ms, Ms, Ms, Aa, Ha, Ha, Qxu, Qxu, Ha, Ai, Ms, Ms, Aa^Vca, Ms, Ms, Ms, Aa, Cea, Ms, Ms, Aa, Ms, Ms^Xm, Ms^Xm, Ms^Xm
Aa, Aa^Vca, Ha, Aa, Ha^Fpa, Ha^Fpa, Ha, Ha, Ha, Ha, Ai, Ms, Ms, Aa, Aa^Fpa, Aa, Aa, Cea, 2 Kea, Cea, Aa, Aa^Vca, Ms, Ms^Xm, Ms^Xm, Ms^Xm
Ha, Ha, Ha, Aa, Ha^Fpa, Ha^Fpa, Ha, Ha, Ai, Ai, Ms, Ms, Aa, Aa^Fpa, Ha, Ha, Aa, Cea, Cea, Cea, Ha, Aa, Ms, Ms, Ms^Xm, Ms^Xm
Aa, Ha, Ha, Ha, Ha, Ha, Ai, Ai, Ms, Ms, Ms^Xm, Ms^Xm, Ha, Ha^Fpa, Aa^Fpa, Aa, Ms, Ms, Ha, Ha, Ms, Ms, Ms, Ms, Ms^Xm, Ms^Xm
Ha, Aa, Ha, Ha, Ai, Ai, Ms, Ms, Ms^Xm, Ms^Xm, Aa, Ha, Aa, Aa^Fpa, Ms, Ms^Vca, Ha, Ha, Ha, Ha, Aa, Ms, Ms, Ms, Ms, Ms^Xm
Ha^Fpa, Ha, Ha, Ha, Ai, Ms, Ms, Aa, Aa, Aa^Fpa, Ha^Fpa, Ha, Aa, Ms, Ha, Ha, Ha, Ha, Aa, Ms, Ms, Ms, Qxu, Qxu, Ms, Ms
Aa^Fpa, Ha^Fpa, Ha, Aa^Vca, Ai, Ms, Aa, Aa, Ha, Aa, Ha^Fpa, Ha^Fpa, Aa^Fpa, Ha, Ha, Aa, Ha, Aa, Aa, Ms, Qxu, Qxu, Ms, Ms, Ms, Ms
Aa, Aa^Fpa, Aa^Fpa, Ha, Ai, Ha, Ms^Xm, Ms^Xm, Ms^Xm, Ha, Aa, Aa^Fpa, Aa^Fpa, Ha^Fpa, Aa, Ha, Aa, Ms, Ms, Ms, Qxu, Qxu, Ms, Ms, Ha, Ms
Aa, Aa, Aa, Ai, Ai, Ms^Xm, Ms^Xm, Ms^Xm, Ms^Xm, Ms^Xm, Aa, Aa, Aa, Aa, Aa, Aa, Aa, Ms, Aa, Qxu, Qxu, Qxu, Ha, Ha, Ha, Ha
