Aa, Ms, Ms, Ms, Aa, Aa, Ms, Qxu, Qxu, Ms^Xm, Ms^Xm, Ms^Xm, Ai, Ai, Ai, Ms, Ms, Md, Ms, Ms, Aa, Ha, Ha, Ha, Ms, Ms
Ms, Ms, Aa, Aa, Ms, Ms, Ms, Qxu, Ms, Ms, Ms, Ms, Ai, Ai, Ai, Ai, Ms, Ha, Ha, Ms, Ms, Aa, Aa, Ms, Ms, Ms
Ha, Ha, Aa, Ms, Ms, Ms, Ms^Xm, Ms, Ms^Vd, Ms, Ms, Ms, Ms, Ai, Ai, Ai, Ha, Aa, Ms, Ha, Ms, Aa^Vca, Aa, Ms, Ms^Xm, Ms
Ha, Aa, Aa, Ms^Xm, Ms^Xm, Ms^Xm, Ms, Ms, Ms, Ms, Ms, Ms, Ai, Ai, Ms, Ha, Ha, Ha, Ha, Ms, Ha^Fpa, Ms^Fpa, Aa^Fpa, Ms^Xm, Ms^Xm, Ms^Xm
Aa, Aa, Ms^Xm, Ms, Cha, Ms, Mv, Ms, Cha, Ms, Ai, Ai, Ms, Ms, Ms, Ms, Ha, Ha, Ha, Ha, Aa, Aa^Fpa, Aa, Ms^Xm, Ms, Ms
Ha, Aa, Ha, Ms^Vd, Cha, Md, Md, Md, Cha, Ms, Ha, Ai, Aa, Aa, Aa^Fpa, Ms, Aa, Aa, Ha, Aa, Aa, Ms, Ms, Aa, Aa, Ms
Aa, Aa, Ms, Ha, Ms, Cha, 1 Kha, Cha, Ms, Ms, Ms, Ai, Ai, Aa, Aa, Aa^Fpa, Aa, Ha, Aa, Ms, Ha, Aa, Aa, Ms, Aa, Aa
Aa, Ha, Ms, Ms, Ms, Ms, Ms, Ms, Ms, Ms, Ms, Ms, Ai, Ha, Ai, Aa, Ai, Aa, Aa, Ms, Ms, Aa, Aa, Ms, Ms^Xm, Ms
Aa, Aa, Ms, Ms, Ms, Ms, Ms, Ms, Ms, Ms, Ha, Ms^Vd, Aa, Ai, Ms, Ai, Aa, Ai, Ai, Ha, Ms, Ms, Ms, Ms^Xm, Ha, Ms
Ha, Aa, Aa, Ms, Ms, Ms, Ms, Ms, Ms, Ha, Ha, Aa, Aa, Aa, Ms, Ms, Ms, Ms, Ha, Ai, Ai, Ha^Vca, Ai, Aa, Ai, Ha
Aa, Ha, Ha, Aa, Aa, Ms^Vd, Ms, Ms, Ha, Ha, Aa, Aa, Ms, Ms, Ms, Ms, Aa, Ms, Ha, Ha, Ms, Ai, Ms, Ai, Ms, Ai
Ms, Ha, Ha, Ha, Ha, Aa, Aa, Ms, Ha, Aa, Aa, Aa, Ms, Ms, Ms, Ms, Ms, Ms, Ha^Fpa, Aa, Aa, Ms, Ha, Ms, Ha, Ms
Ms^Fpa, Ha, Ha, Ha, Ha, Ha, Ha, Aa, Aa, Aa, Ms, Aa, Aa, Ms, Ms, Ms, Ms, Ms, Ha^Fpa, Ha, Ha, Ha, Ha, Ha, Ha, Ha
Ms, Ha, Aa, Aa, Aa, Ha, Ha^Fpa, Ha, Aa, Aa, Ms, Ms, Ms, Qxu, Qxu, Ha, Ha, Ha^Fpa, Ha^Fpa, Ha, Ha^Vca, Ha, Ha, Ha, Ha, Ha
Ha, Ha, Aa, Ms, Aa, Ms, Aa, Ha, Ha, Aa, Ms, Ms, Ms, Qxu, Qxu, Ha, Ms, Ha, Ms, Ha, Ha, Ha, Ha, Ha, Ha, Ha
Qxu, Ha, Ha, Ms, Ms, Ms, Ms, Aa, Aa, Ha, Aa^Fpa, Ms, Ms, Ms, Qxu, Qxu, Ms, Ms^Xm, Ms^Xm, Ms, Ha, Ha, Ha, Ha, Ha, Ha
Ms, Aa, Ha, Aa, Ms, Ms, Ms, Ms, Aa, Ha, Aa^Fpa, Ms^Fpa, Ai, Ha, Ha, Ha, Ha, Ms, Ms^Xm, Ms, Aa, Ms, Ms, Ms, Ms, Ms
Ms, Ms, Ha, Ha, Ms, Ms, Ms, Ms, Aa, Ha, Ai, Ai, Ai, Ai, Ha, Ha, Aa, Ha, Ha, Ms, Ha, Ha, Ha, Ha, Ha, Ha
Ms, Aa, Ha, Aa, Aa, Ms, Ms^Vca, Ms, Ha, Ha, Ai, Ai, Ai, Ai, Ha, Ha, Ha, Ha^Vca, Aa, Ms, Ms, Qxu, Qxu, Ha, Aa, Ha
Ms, Ha, Aa, Aa, Ms, Aa, Ms, Ms, Ms, Ms, Ha, Ai, Ms, Ms, Ms, Ms, Ms, Ms, Aa, Aa, Aa^Fpa, Qxu, Ha, Qxu, Ha^Fpa, Ha
Ms^Xm, Ms^Xm, Ms, Ms, Aa, Ms, Ha, Ha, Ha, Ha, Ha, Ai, Ai, Ms, Aa, Ha, Ha, Ha, Ha^Fpa, Ha^Fpa, Ha, Ha, Aa, Ha^Fpa, Ms^Fpa, Ms^Fpa
Ms^Xm, Ms^Xm, Ms^Xm, Aa, Aa, Aa, Ha, Ha, Ha, Ha^Vca, Ha, Ha, Ha, Ai, Ms^Xm, Aa, Aa, Aa, Aa^Fpa, Aa, Ms, Aa, Ms, Ms, Ms, Aa^Fpa
Aa, Ms, Ms^Fpa, Ms^Xm, Ms, Ha, Ha, Ha, Ms, Ms, Ms^Xm, Ms^Xm, Ms^Xm, Ai, Ms^Xm, Ms^Xm, Ms^Xm, Ms, Ms^Fpa, Ms, Ms, Ms, Ms, Ms, Ms, Ms
Ha, Ha^Fpa, Ha, Ms, Ms, Ha, Ms, Ms, Ms, Ms, Ms, Ms, Ms, Ai, Ms, Ms, Ms, Ms, Ms, Ms, Ha, Ms, Ms, Ms, Ms, Ms
Ha, Ha, Ha, Ha, Ms, Ms, Ms, Ms, Aa, Ms, Ms, Ms, Ms, Ai, Ms, Ms, Ms, Ms, Ha, Ms, Ms, Ms^Xm, Ms^Xm, Ms, Ms, Ms
Ha^Fpa, Ha, Ha, Ha, Md, Mv, Md, Ms, Qxu, Aa, Aa^Fpa, Aa, Aa^Fpa, Ai, Ms, Aa, Ms, Aa, Aa, Ha, Ha, Aa, Aa^Fpa, Ms, Aa, Ms
Aa^Fpa, Ha^Fpa, Aa, Ha, Aa, Md, Ha, Ha, Qxu, Aa^Fpa, Aa^Fpa, Aa^Fpa, Ms, Ai, Ms, Ms, Ms, Aa, Ms, Ha, Ha, Aa, Aa^Fpa, Aa^Fpa, Ms, Aa
Ms, Ms, Ms, Aa, Aa, Ha, Qxu, Qxu, Qxu, Aa^Fpa, Aa, Ms, Ai, Ai, Aa^Vca, Ms, Aa, Ms, Aa, Ms, Ha, Aa, Ms, Ms, Ms, Ms
Ms, Ms, Ms, Aa, Aa, Qxu, Ha, Ms^Fpa, Ms, Ms, Ai, Ai, Aa, Aa, Aa, Aa, Aa, Ha, Ha, Ha, Aa, Aa, Ms, Ms, Ms^Xm, Ms^Xm
Ms, Ms, Ms, Ms, Aa, Ha, Ha, Ms^Xm, Ai, Ai, Ms, Ms, Ms, Ms, Ms, Ms, Ms, Aa, Cea, Ms, Ms, Aa, Ms, Ms^Xm, Ms^Xm, Ms^Xm
Aa, Aa^Vca, Ha, Aa, Ha, Ha, Ai, Ai, Ms, Ms, Ms^Xm, Ms, Ms, Aa, Aa^Fpa, Aa, Aa, Cea, 2 Kea, Cea, Aa, Aa^Vca, Ms, Ms^Xm, Ms^Xm, Ms^Xm
Ha, Ha, Ha, Aa, Ai, Ai, Ha, Ms, Ms, Ms^Xm, Ms^Xm, Ms, Aa, Aa^Fpa, Ha, Ha, Aa, Cea, Cea, Cea, Ha, Aa, Ms, Ms, Ms^Xm, Ms^Xm
Aa, Ha, Ha, Ha, Ai, Ai, Ms, Ms, Ms^Xm, Ms^Xm, Aa, Ha, Ha, Ha^Fpa, Aa^Fpa, Aa, Ms, Ms, Ha, Ha, Ms, Ms, Ms, Ms, Ms^Xm, Ms^Xm
Ha, Aa, Ha, Ha, Ai, Aa, Ms, Ms^Xm, Aa^Fpa, Aa, Aa, Ha, Aa, Aa^Fpa, Ms, Ms^Vca, Ha, Ha, Ha, Ha, Aa, Ms, Ms, Ms, Ms, Ms^Xm
Ha^Fpa, Ha, Ha, Ha, Ai, Ms, Ms, Aa, Aa, Aa^Fpa, Ha^Fpa, Ha, Aa, Ms, Ha, Ha, Ha, Ha, Aa, Ms, Ms, Ms, Qxu, Qxu, Ms, Ms
Aa^Fpa, Ha^Fpa, Ha, Aa^Vca, Ai, Ms, Aa, Aa, Ha, Aa, Ha^Fpa, Ha^Fpa, Aa^Fpa, Ha, Ha, Aa, Ha, Aa, Aa, Ms, Qxu, Qxu, Ms, Ms, Ms, Ms
Aa, Aa^Fpa, Aa^Fpa, Ha, Ai, Ha, Ms^Xm, Ms^Xm, Ms^Xm, Ha, Aa, Aa^Fpa, Aa^Fpa, Ha^Fpa, Aa, Ha, Aa, Ms, Ms, Ms, Qxu, Qxu, Ms, Ms, Ha, Ms
Aa, Aa, Aa, Ai, Ai, Ms^Xm, Ms^Xm, Ms^Xm, Ms^Xm, Ms^Xm, Aa, Aa, Aa, Aa, Aa, Aa, Aa, Ms, Aa, Qxu, Qxu, Qxu, Ha, Ha, Ha, Ha
